chr,start,end,cM,exonbp,genetic,midpos
1,15,9344,1_-8,5572,-8,5587
1,93056,271853,1_-7,8428,-7,101484
1,332386,517946,1_-6,10961,-6,343347
1,644466,761875,1_-5,7268,-5,651734
1,833416,1037879,1_-4,21455,-4,854871
1,1069182,1225620,1_-3,4797,-3,1073979
1,1481835,1568163,1_-2,2379,-2,1484214
1,1665424,1791178,1_-1,7291,-1,1672715
1,1860107,2047054,1_0,24463,0,1884570
1,2088413,2307914,1_1,29140,1,2117553
1,2354362,2566974,1_2,21998,2,2376360
1,2658546,2803584,1_3,44096,3,2702642
1,2842428,3079599,1_4,32296,4,2874724
1,3081091,3286673,1_5,37650,5,3118741
1,3354212,3563339,1_6,29818,6,3384030
1,3563883,3745372,1_7,32280,7,3596163
1,3831024,4025504,1_8,21402,8,3852426
1,4037632,4249922,1_9,19105,9,4056737
1,4288474,4453314,1_10,28607,10,4317081
1,4508518,4722519,1_11,14214,11,4522732
1,4724357,4873591,1_12,13983,12,4738340
1,4978713,5094256,1_13,28503,13,5007216
1,5223275,5393491,1_14,34102,14,5257377
1,5406086,5590615,1_15,30712,15,5436798
1,5610830,5824370,1_16,22653,16,5633483
1,5830112,6035837,1_17,11011,17,5841123
1,6059177,6251875,1_18,38431,18,6097608
1,6410785,6434186,1_19,6353,19,6417138
1,6533244,6614901,1_20,11118,20,6544362
1,6777316,6851476,1_21,10247,21,6787563
1,6921027,7091517,1_22,28633,22,6949660
1,7123416,7314794,1_23,20171,23,7143587
1,7341771,7494098,1_24,25221,24,7366992
1,7556485,7763324,1_25,18693,25,7575178
1,7767644,7975982,1_26,12117,26,7779761
1,7995698,8147689,1_27,39587,27,8035285
1,8207459,8428316,1_28,27560,28,8235019
1,8428782,8638292,1_29,25975,29,8454757
1,8656205,8883362,1_30,8353,30,8664558
1,8883621,9096450,1_31,22387,31,8906008
1,9118441,9309992,1_32,17617,32,9136058
1,9355578,9586957,1_33,37482,33,9393060
1,9697186,9812735,1_34,7802,34,9704988
1,9903016,10092865,1_35,20993,35,9924009
1,10093027,10236147,1_36,6021,36,10099048
1,10436145,10592626,1_37,17196,37,10453341
1,10665964,10878366,1_38,10481,38,10676445
1,10898624,11175542,1_39,31207,39,10929831
1,11211531,11472457,1_40,12109,40,11223640
1,11473386,11763648,1_41,19531,41,11492917
1,11791937,11993432,1_42,13673,42,11805610
1,12093527,12399090,1_43,58568,43,12152095
1,12421665,12663563,1_44,35358,44,12457023
1,12814516,13074539,1_45,23028,45,12837544
1,13131669,13470706,1_46,35356,46,13167025
1,13537082,13866789,1_47,56333,47,13593415
1,13991694,14170158,1_48,19224,48,14010918
1,14376373,14683580,1_49,25405,49,14401778
1,14780567,15142697,1_50,42307,50,14822874
1,15159465,15573543,1_51,21557,51,15181022
1,15610597,16067901,1_52,41231,52,15651828
1,16119125,16477201,1_53,38030,53,16157155
1,16575183,17064313,1_54,33274,54,16608457
1,17083389,17528139,1_55,27942,55,17111331
1,17618846,18056763,1_56,65422,56,17684268
1,18129328,18594613,1_57,17117,57,18146445
1,18622781,19110663,1_58,19363,58,18642144
1,19233048,19643044,1_59,25379,59,19258427
1,19692835,20115641,1_60,42022,60,19734857
1,20213372,20701598,1_61,28221,61,20241593
1,20704034,21219567,1_62,20380,62,20724414
1,21246673,21722354,1_63,62060,63,21308733
1,21755510,22262412,1_64,18912,64,21774422
1,22373739,22776525,1_65,50964,65,22424703
1,22847025,23252318,1_66,35462,66,22882487
1,23350356,23733637,1_67,12802,67,23363158
1,23877963,24309702,1_68,19677,68,23897640
1,24403777,24813391,1_69,29785,69,24433562
1,24931842,25393624,1_70,38722,70,24970564
1,25394286,25891900,1_71,58056,71,25452342
1,26037370,26446478,1_72,32817,72,26070187
1,26495060,26951639,1_73,23946,73,26519006
1,27071710,27554931,1_74,42017,74,27113727
1,27616879,28081167,1_75,34364,75,27651243
1,28202929,28688607,1_76,50735,76,28253664
1,28765279,29272868,1_77,39986,77,28805265
1,29355610,29933212,1_78,28557,78,29384167
1,29935153,30540271,1_79,33233,79,29968386
1,30569636,31074701,1_80,57814,80,30627450
1,31201538,31777054,1_81,31156,81,31232694
1,31833220,32405888,1_82,49075,82,31882295
1,32483351,32995514,1_83,28444,83,32511795
1,33111823,33583537,1_84,34890,84,33146713
1,33629795,34158504,1_85,22317,85,33652112
1,34203048,34719739,1_86,51423,86,34254471
1,34814008,35240190,1_87,24894,87,34838902
1,35494182,35747672,1_88,23039,88,35517221
1,35763432,36232433,1_89,28178,89,35791610
1,36345175,36569387,1_90,15027,90,36360202
1,36800698,37154236,1_91,15075,91,36815773
1,37200694,37589122,1_92,26429,92,37227123
1,37663500,38061075,1_93,23780,93,37687280
1,38102120,38550415,1_94,50338,94,38152458
1,38609594,38880032,1_95,42666,95,38652260
1,39013424,39441372,1_96,64207,96,39077631
1,39450966,39900071,1_97,30514,97,39481480
1,39901199,40357883,1_98,23844,98,39925043
1,40397407,40811386,1_99,42300,99,40439707
1,40912444,41359027,1_100,27621,100,40940065
1,41373080,41875972,1_101,45775,101,41418855
1,41956676,42477131,1_102,40064,102,41996740
1,42479943,43089359,1_103,49053,103,42528996
1,43105861,43771536,1_104,77068,104,43182929
1,43971509,44507450,1_105,34081,105,44005590
1,44525260,45281636,1_106,27961,106,44553221
1,45337345,46079332,1_107,81781,107,45419126
1,46118540,46866179,1_108,51599,108,46170139
1,46923696,47600237,1_109,62685,109,46986381
1,47773429,47995673,1_110,9533,110,47782962
1,48505748,48891289,1_111,23539,111,48529287
1,48957150,49414176,1_112,28916,112,48986066
1,49617507,49977977,1_113,24541,113,49642048
1,50025239,50439481,1_114,22727,114,50047966
1,50475209,50908662,1_115,14536,115,50489745
1,50951444,51323393,1_116,30771,116,50982215
1,51366723,51762211,1_117,9145,117,51375868
1,51851566,52162105,1_118,23963,118,51875529
1,52195035,52568433,1_119,22918,119,52217953
1,52603047,52924952,1_120,19981,120,52623028
1,53008416,53345793,1_121,22854,121,53031270
1,53405584,53778732,1_122,7843,122,53413427
1,53822612,54190513,1_123,24374,123,53846986
1,54266151,54629064,1_124,38654,124,54304805
1,54727889,55085399,1_125,24847,125,54752736
1,55139315,55573169,1_126,31711,126,55171026
1,55745521,56225765,1_127,22510,127,55768031
1,56283466,56895124,1_128,75825,128,56359291
1,56929022,57749398,1_129,39632,129,56968654
1,57791379,59085795,1_130,42965,130,57834344
1,59146944,62500994,1_131,203424,131,59350368
1,62503593,65120460,1_132,126285,132,62629878
1,65221196,66781685,1_133,78837,133,65300033
1,66784948,68136110,1_134,97827,134,66882775
1,68136347,69290479,1_135,53524,135,68189871
1,69399777,70428293,1_136,33127,136,69432904
1,70503386,71580619,1_137,43209,137,70546595
1,71586541,72619089,1_138,44128,138,71630669
1,72701761,73641329,1_139,41021,139,72742782
1,73686544,74631168,1_140,39753,140,73726297
1,74674454,75648206,1_141,32087,141,74706541
1,75680676,76677958,1_142,21312,142,75701988
1,76731528,77628031,1_143,41366,143,76772894
1,77797725,79006782,1_144,29528,144,77827253
1,79068251,80664777,1_145,96200,145,79164451
1,80681057,83010593,1_146,109418,146,80790475
1,83076155,85065032,1_147,85373,147,83161528
1,85337268,87027559,1_148,57564,148,85394832
1,87150400,88455261,1_149,56673,149,87207073
1,88478645,89842202,1_150,43932,150,88522577
1,89961379,91267799,1_151,44100,151,90005479
1,91340426,92907607,1_152,50084,152,91390510
1,93071432,95099759,1_153,76479,153,93147911
1,95100679,97041198,1_154,50991,154,95151670
1,97113278,98761780,1_155,39526,155,97152804
1,98853892,100375159,1_156,37312,156,98891204
1,100568121,102247791,1_157,52301,157,100620422
1,102433271,155927056,1_158,951220,158,103384491
1,117703629,158008210,1_159,680696,159,118384325
1,120848224,159363718,1_160,653228,160,121501452
1,159715287,160859387,1_161,29938,161,159745225
1,160915458,162104901,1_162,30358,162,160945816
1,162159349,163443628,1_163,56638,163,162215987
1,163523637,164835758,1_164,22219,164,163545856
1,164945188,166507222,1_165,50909,165,164996097
1,166667572,168576308,1_166,73195,166,166740767
1,168693295,170930272,1_167,58549,167,168751844
1,170932852,172863280,1_168,77005,168,171009857
1,172875276,174296453,1_169,89293,169,172964569
1,174313077,175431597,1_170,39935,170,174353012
1,175485597,176213696,1_171,26074,171,175511671
1,176413840,177152658,1_172,57338,172,176471178
1,177422682,178008988,1_173,17547,173,177440229
1,178266054,178714577,1_174,28446,174,178294500
1,178769042,179376442,1_175,18835,175,178787877
1,179567071,180019427,1_176,32103,176,179599174
1,180102867,180625849,1_177,39435,177,180142302
1,180688667,181309198,1_178,38598,178,180727265
1,181339036,181889583,1_179,10637,179,181349673
1,182049804,182544469,1_180,36617,180,182086421
1,182621345,183151244,1_181,30343,181,182651688
1,183301375,183812113,1_182,55606,182,183356981
1,183839914,184246811,1_183,31334,183,183871248
1,184451526,184967194,1_184,27872,184,184479398
1,185194852,185555381,1_185,17291,185,185212143
1,185740131,186232468,1_186,1154,186,185741285
1,186359540,186680624,1_187,7759,187,186367299
1,186997341,187273180,1_188,20895,188,187018236
1,187342575,187724417,1_189,37304,189,187379879
1,187839232,188259837,1_190,46226,190,187885458
1,188303856,188741382,1_191,12879,191,188316735
1,188747860,189150017,1_192,26908,192,188774768
1,189190072,189595948,1_193,68239,193,189258311
1,189638219,189838371,1_194,11207,194,189649426
1,190044089,190396354,1_195,8473,195,190052562
1,190428604,190768862,1_196,58663,196,190487267
1,190998510,191098991,1_197,10093,197,191008603
1,191199319,191583449,1_198,33124,198,191232443
1,191584689,191917195,1_199,18155,199,191602844
1,191987586,192282080,1_200,8824,200,191996410
1,192395460,192704091,1_201,22481,201,192417941
1,192730982,193047183,1_202,11925,202,192742907
1,193123446,193456589,1_203,28319,203,193151765
1,193520071,193830910,1_204,15933,204,193536004
1,193863105,194219253,1_205,16165,205,193879270
1,194449104,194575539,1_206,20326,206,194469430
1,194657738,195042230,1_207,30715,207,194688453
1,195042536,195418343,1_208,21988,208,195064524
1,195483240,195892697,1_209,36522,209,195519762
1,195907731,196339863,1_210,44893,210,195952624
1,196371524,196773050,1_211,63669,211,196435193
1,196967384,197260463,1_212,13014,212,196980398
1,197260836,197717358,1_213,19154,213,197279990
1,197738767,198198961,1_214,12791,214,197751558
1,198230715,198655977,1_215,37102,215,198267817
1,198732440,199117873,1_216,23686,216,198756126
1,199269843,199641175,1_217,23026,217,199292869
1,199685089,200162527,1_218,32290,218,199717379
1,200247732,200639600,1_219,28795,219,200276527
1,200683325,200863765,1_220,13846,220,200697171
1,201190018,201641181,1_221,25841,221,201215859
1,201729280,202169861,1_222,38494,222,201767774
1,202293405,202649942,1_223,24601,223,202318006
1,202720078,203174187,1_224,35208,224,202755286
1,203249564,203745514,1_225,25317,225,203274881
1,203824194,204307189,1_226,51464,226,203875658
1,204364342,204874636,1_227,60900,227,204425242
1,204947075,205563130,1_228,66186,228,205013261
1,205563631,206201732,1_229,38361,229,205601992
1,206251843,206898508,1_230,29574,230,206281417
1,206965123,207613058,1_231,34207,231,206999330
1,207684865,208316850,1_232,35943,232,207720808
1,208431306,208990648,1_233,24886,233,208456192
1,209119565,209827128,1_234,29099,234,209148664
1,209988187,210485842,1_235,39362,235,210027549
1,210523299,211007804,1_236,20863,236,210544162
1,211197216,211676248,1_237,54390,237,211251606
1,212040900,212358423,1_238,23061,238,212063961
1,212484743,212953972,1_239,23516,239,212508259
1,212976083,213361976,1_240,45661,240,213021744
1,213530089,213980457,1_241,28181,241,213558270
1,214102115,214596922,1_242,20175,242,214122290
1,214648810,215092071,1_243,20423,243,214669233
1,215151889,215611037,1_244,16189,244,215168078
1,215668874,216165502,1_245,20584,245,215689458
1,216299908,216791764,1_246,32282,246,216332190
1,216871717,217391134,1_247,20940,247,216892657
1,217451428,217944037,1_248,20054,248,217471482
1,218082823,218800974,1_249,30123,249,218112946
1,218887162,219568201,1_250,35670,250,218922832
1,219770403,220714868,1_251,46284,251,219816687
1,220776301,221947925,1_252,81417,252,220857718
1,222009214,223326283,1_253,80961,253,222090175
1,223370473,224687924,1_254,86472,254,223456945
1,224698636,225687566,1_255,55274,255,224753910
1,225866503,226763628,1_256,68963,256,225935466
1,226774922,227535811,1_257,45957,257,226820879
1,227583946,228261266,1_258,51227,258,227635173
1,228317466,228974805,1_259,33801,259,228351267
1,228983364,229613705,1_260,37828,260,229021192
1,229661023,230222170,1_261,66737,261,229727760
1,230354259,230887268,1_262,27861,262,230382120
1,230921212,231527079,1_263,29787,263,230950999
1,231591523,232055133,1_264,25219,264,231616742
1,232276520,232924162,1_265,44340,265,232320860
1,232924278,233720151,1_266,32353,266,232956631
1,233750600,234566205,1_267,50754,267,233801354
1,234740225,235580111,1_268,43933,268,234784158
1,235645210,236574267,1_269,50942,269,235696152
1,236794631,237969284,1_270,68592,270,236863223
1,238018575,238829331,1_271,41193,271,238059768
1,239103401,240025446,1_272,49370,272,239152771
1,240039326,240787131,1_273,45730,273,240085056
1,240841946,241481889,1_274,42047,274,240883993
1,241500944,242082585,1_275,37588,275,241538532
1,242140881,242602096,1_276,18586,276,242159467
1,242708914,243146191,1_277,17446,277,242726360
1,243158766,243655743,1_278,19118,278,243177884
1,243781874,244090135,1_279,14010,279,243795884
1,244154725,244608722,1_280,18252,280,244172977
1,244734303,245045530,1_281,27050,281,244761353
1,245087270,245530627,1_282,13954,282,245101224
1,245693259,245994978,1_283,12947,283,245706206
1,246027150,246523902,1_284,34587,284,246061737
1,246524052,247015939,1_285,66924,285,246590976
1,247133095,247549190,1_286,7767,286,247140862
1,247616228,248126224,1_287,41164,287,247657392
1,248140276,248740364,1_288,42108,288,248182384
1,248740430,249371438,1_289,20900,289,248761330
1,249378919,249916425,1_290,21445,290,249400364
1,250062101,250654902,1_291,48150,291,250110251
1,250863091,251387856,1_292,38493,292,250901584
1,251440786,251995738,1_293,25593,293,251466379
1,252134172,252735555,1_294,18143,294,252152315
1,252794748,253376161,1_295,43118,295,252837866
1,253380440,253956566,1_296,35256,296,253415696
1,254034532,254532425,1_297,22734,297,254057266
1,254533094,254995662,1_298,25163,298,254558257
1,255083940,255550986,1_299,21994,299,255105934
1,255634943,256098502,1_300,37195,300,255672138
1,256227274,256571387,1_301,46472,301,256273746
1,256659469,257187558,1_302,17319,302,256676788
1,257187960,257694027,1_303,21182,303,257209142
1,257735949,258249246,1_304,38519,304,257774468
1,258283674,258809127,1_305,36412,305,258320086
1,258868763,259474815,1_306,56287,306,258925050
1,259516702,260150705,1_307,53173,307,259569875
1,260219121,260972778,1_308,29730,308,260248851
1,260973078,261666866,1_309,36832,309,261009910
1,261878241,262896601,1_310,74944,310,261953185
1,262941819,263906344,1_311,54874,311,262996693
1,264085820,265167501,1_312,113820,312,264199640
1,265317504,266370341,1_313,47450,313,265364954
1,266516739,267328833,1_314,40193,314,266556932
1,267333976,267966710,1_315,66115,315,267400091
1,268152318,268814622,1_316,43087,316,268195405
1,268871485,269523885,1_317,59693,317,268931178
1,269549540,270135481,1_318,17016,318,269566556
1,270248408,270837729,1_319,38857,319,270287265
1,270876861,271449565,1_320,47662,320,270924523
1,271562811,272221063,1_321,23907,321,271586718
1,272254457,273037433,1_322,43636,322,272298093
1,273090953,273871571,1_323,54786,323,273145739
1,273983843,275010974,1_324,95708,324,274079551
1,275027071,276081122,1_325,100541,325,275127612
1,276111081,277059264,1_326,175965,326,276287046
1,277132396,277739299,1_327,32414,327,277164810
1,277837082,278446751,1_328,57836,328,277894918
1,278484028,278932730,1_329,35800,329,278519828
1,278992107,279424253,1_330,18120,330,279010227
1,279475226,279877855,1_331,31859,331,279507085
1,279879413,280226598,1_332,22435,332,279901848
1,280341782,280637031,1_333,29757,333,280371539
1,280677266,280980422,1_334,30195,334,280707461
1,281022861,281333891,1_335,18094,335,281040955
1,281400080,281664663,1_336,17182,336,281417262
1,281706504,282010664,1_337,27292,337,281733796
1,282022327,282351103,1_338,2656,338,282024983
1,282375062,282673963,1_339,19183,339,282394245
1,282675292,282919796,1_340,32421,340,282707713
1,283086231,283325036,1_341,28938,341,283115169
1,283328910,283647110,1_342,14346,342,283343256
1,283748301,283972601,1_343,10548,343,283758849
1,284005019,284249922,1_344,17587,344,284022606
1,284373531,284671849,1_345,3874,345,284377405
1,284910563,285024436,1_346,0,346,284910563
1,285061784,285340424,1_347,36032,347,285097816
1,285389524,285648105,1_348,13458,348,285402982
1,285770140,286125730,1_349,37279,349,285807419
1,286171595,286529357,1_350,28214,350,286199809
1,286613503,286863034,1_351,37590,351,286651093
1,286951770,287336444,1_352,36443,352,286988213
1,287475221,287821266,1_353,65330,353,287540551
1,287841540,288269121,1_354,38098,354,287879638
1,288392315,288698769,1_355,11845,355,288404160
1,288731924,289133720,1_356,33334,356,288765258
1,289192544,289586224,1_357,42921,357,289235465
1,289596927,290011749,1_358,17927,358,289614854
1,290103808,290395697,1_359,57006,359,290160814
1,290404107,290719109,1_360,31878,360,290435985
1,290805291,291115569,1_361,37012,361,290842303
1,291254712,291474561,1_362,9001,362,291263713
1,291474958,291796347,1_363,21687,363,291496645
1,291862918,292103738,1_364,21112,364,291884030
1,292133875,292404115,1_365,40075,365,292173950
1,292410718,292699171,1_366,19265,366,292429983
1,292709127,292932620,1_367,9101,367,292718228
1,292986873,293223070,1_368,33425,368,293020298
1,293266390,293483693,1_369,12341,369,293278731
1,293519662,293665225,1_370,16529,370,293536191
1,293793289,293999250,1_371,14258,371,293807547
1,294043690,294168478,1_372,15176,372,294058866
1,294467596,294501269,1_373,6989,373,294474585
1,294625516,294742842,1_374,15371,374,294640887
1,294812731,295003894,1_375,15921,375,294828652
1,295017123,295192794,1_376,15758,376,295032881
1,295260479,295488395,1_377,40020,377,295300499
1,295490232,295724713,1_378,10783,378,295501015
1,295753245,295890730,1_379,16756,379,295770001
1,295987553,296206509,1_380,39469,380,296027022
1,296252620,296341350,1_381,7133,381,296259753
1,296562503,296667184,1_382,16725,382,296579228
1,296708996,296929400,1_383,37956,383,296746952
1,296943761,297056123,1_384,25535,384,296969296
1,297181390,297378918,1_385,22095,385,297203485
1,297435088,297608050,1_386,24125,386,297459213
1,297744197,297917282,1_387,36066,387,297780263
1,297960418,298157674,1_388,23090,388,297983508
1,298220013,298438694,1_389,34680,389,298254693
1,298497150,298695244,1_390,19305,390,298516455
1,298734562,298969918,1_391,21255,391,298755817
1,298974400,299202254,1_392,31207,392,299005607
1,299282115,299470354,1_393,20856,393,299302971
1,299526826,299753698,1_394,22180,394,299549006
1,299882564,299990962,1_395,15865,395,299898429
1,300065185,300283806,1_396,18712,396,300083897
1,300346827,300535738,1_397,26291,397,300373118
1,300636641,300870609,1_398,11767,398,300648408
1,300931553,300995220,1_399,4505,399,300936058
1,301283990,301283990,1_400,0,400,301283990
2,9167,137334,2_-3,2587,-3,11754
2,168451,273477,2_-2,1782,-2,170233
2,364344,566238,2_-1,1511,-1,365855
2,606030,754425,2_0,10179,0,616209
2,840687,961679,2_1,35792,1,876479
2,1036303,1141392,2_2,12994,2,1049297
2,1186913,1360754,2_3,29327,3,1216240
2,1434136,1568234,2_4,41558,4,1475694
2,1624717,1777826,2_5,31879,5,1656596
2,1778222,1974407,2_6,45710,6,1823932
2,1976835,2128118,2_7,37422,7,2014257
2,2167711,2339294,2_8,18225,8,2185936
2,2361701,2541552,2_9,29636,9,2391337
2,2541876,2685345,2_10,23684,10,2565560
2,2782845,2820383,2_11,14086,11,2796931
2,3009551,3090235,2_12,21058,12,3030609
2,3090993,3231303,2_13,23675,13,3114668
2,3293481,3423741,2_14,27945,14,3321426
2,3541384,3614754,2_15,20745,15,3562129
2,3667969,3807206,2_16,35819,16,3703788
2,3807369,3973668,2_17,39974,17,3847343
2,3990032,4170428,2_18,10240,18,4000272
2,4174080,4353162,2_19,32034,19,4206114
2,4363667,4514263,2_20,12480,20,4376147
2,4570763,4701134,2_21,30198,21,4600961
2,4826228,4898674,2_22,21378,22,4847606
2,4988560,5154276,2_23,31413,23,5019973
2,5214595,5381231,2_24,12675,24,5227270
2,5424170,5625044,2_25,21044,25,5445214
2,5681333,5928748,2_26,45131,26,5726464
2,5929400,6203012,2_27,50854,27,5980254
2,6314948,6572513,2_28,40028,28,6354976
2,6582666,6917748,2_29,36948,29,6619614
2,6972932,7357855,2_30,69461,30,7042393
2,7401897,7745349,2_31,36711,31,7438608
2,7843025,8253471,2_32,31788,32,7874813
2,8267082,8579516,2_33,45616,33,8312698
2,8718612,8964461,2_34,49220,34,8767832
2,8992269,9136053,2_35,29297,35,9021566
2,9262674,9514070,2_36,36702,36,9299376
2,9544743,9623751,2_37,12900,37,9557643
2,9812186,9997274,2_38,29614,38,9841800
2,9997403,10144025,2_39,7051,39,10004454
2,10209850,10392766,2_40,24414,40,10234264
2,10460095,10608899,2_41,51739,41,10511834
2,10624481,10789882,2_42,35553,42,10660034
2,10856408,10961025,2_43,3148,43,10859556
2,10993526,11101632,2_44,4768,44,10998294
2,11198095,11360619,2_45,15075,45,11213170
2,11360714,11549774,2_46,16579,46,11377293
2,11558120,11737706,2_47,26415,47,11584535
2,11751742,11934788,2_48,25140,48,11776882
2,11935008,12129751,2_49,51337,49,11986345
2,12136809,12344693,2_50,16458,50,12153267
2,12346978,12564603,2_51,16534,51,12363512
2,12564618,12800640,2_52,11764,52,12576382
2,12800738,13025201,2_53,20737,53,12821475
2,13090766,13313900,2_54,21063,54,13111829
2,13332999,13597613,2_55,23496,55,13356495
2,13612490,13881005,2_56,30346,56,13642836
2,13952884,14232754,2_57,10627,57,13963511
2,14255879,14549536,2_58,43953,58,14299832
2,14611892,14878293,2_59,27362,59,14639254
2,14884176,15141772,2_60,10537,60,14894713
2,15241902,15343738,2_61,8464,61,15250366
2,15471727,15705152,2_62,15085,62,15486812
2,15866049,15915593,2_63,9927,63,15875976
2,15968058,16131927,2_64,36242,64,16004300
2,16219598,16368756,2_65,19549,65,16239147
2,16392324,16548654,2_66,13948,66,16406272
2,16633016,16679229,2_67,6528,67,16639544
2,16771050,16938511,2_68,11089,68,16782139
2,16939852,17103984,2_69,13586,69,16953438
2,17153594,17257126,2_70,5510,70,17159104
2,17333482,17435873,2_71,12552,71,17346034
2,17476222,17612032,2_72,18114,72,17494336
2,17653192,17691198,2_73,3195,73,17656387
2,17788606,17904865,2_74,26208,74,17814814
2,17975755,18077381,2_75,12619,75,17988374
2,18111755,18251015,2_76,36511,76,18148266
2,18251174,18365351,2_77,6100,77,18257274
2,18417247,18514057,2_78,9811,78,18427058
2,18613232,18710145,2_79,11024,79,18624256
2,18719691,18814760,2_80,10369,80,18730060
2,18999645,18999645,2_81,0,81,18999645
2,19038474,19196079,2_82,8369,82,19046843
2,19196144,19326674,2_83,16408,83,19212552
2,19357935,19461517,2_84,11542,84,19369477
2,19535111,19647660,2_85,3513,85,19538624
2,19774881,19839234,2_86,6503,86,19781384
2,19909593,20033060,2_87,13390,87,19922983
2,20096273,20205789,2_88,10941,88,20107214
2,20362485,20420313,2_89,11643,89,20374128
2,20524552,20607704,2_90,17222,90,20541774
2,20677721,20859383,2_91,11181,91,20688902
2,20924879,21170213,2_92,12114,92,20936993
2,21190010,21484091,2_93,36446,93,21226456
2,21484261,21822211,2_94,33626,94,21517887
2,21872922,22295974,2_95,28353,95,21901275
2,22396585,23224225,2_96,53288,96,22449873
2,23315311,27057050,2_97,279711,97,23595022
2,27201472,27893671,2_98,43568,98,27245040
2,27934332,28406282,2_99,41331,99,27975663
2,28563961,29054925,2_100,43119,100,28607080
2,29076230,29545694,2_101,35655,101,29111885
2,29623242,30002276,2_102,37642,102,29660884
2,30130315,30593559,2_103,51217,103,30181532
2,30810239,31352809,2_104,62900,104,30873139
2,31403940,36569445,2_105,280765,105,31684705
2,32492589,38342576,2_106,355049,106,32847638
2,38541034,39438810,2_107,63594,107,38604628
2,39536859,40350963,2_108,29476,108,39566335
2,40408884,41246832,2_109,42910,109,40451794
2,41296460,42113693,2_110,49227,110,41345687
2,42234498,43039018,2_111,40765,111,42275263
2,43091306,43838806,2_112,50278,112,43141584
2,44013002,44722817,2_113,80675,113,44093677
2,44771807,45595553,2_114,31794,114,44803601
2,45601786,46538175,2_115,49785,115,45651571
2,46563289,47812124,2_116,59386,116,46622675
2,47852426,51103230,2_117,127670,117,47980096
2,51174463,57205906,2_118,213137,118,51387600
2,57253514,59377827,2_119,80871,119,57334385
2,59448563,60770601,2_120,61624,120,59510187
2,60871696,61971273,2_121,26239,121,60897935
2,61997611,62999380,2_122,29800,122,62027411
2,63035216,63960250,2_123,27464,123,63062680
2,64388630,65040039,2_124,23457,124,64412087
2,65134707,65852404,2_125,8449,125,65143156
2,66223360,67544339,2_126,22403,126,66245763
2,67755189,69393420,2_127,63497,127,67818686
2,69563728,88374713,2_128,382526,128,69946254
2,76151148,137282834,2_129,1124497,129,77275645
2,122238507,147380349,2_130,537803,130,122776310
2,142169008,149608742,2_131,243381,131,142412389
2,149764238,150840502,2_132,28725,132,149792963
2,151021628,152207048,2_133,17961,133,151039589
2,152207464,159735513,2_134,253749,134,152461213
2,159987801,162095023,2_135,78571,135,160066372
2,162230099,163570229,2_136,38540,136,162268639
2,163677129,165069568,2_137,63261,137,163740390
2,165103588,174612251,2_138,437171,138,165540759
2,174673219,177443225,2_139,122747,139,174795966
2,177496553,179751277,2_140,85437,140,177581990
2,179802715,181547802,2_141,49700,141,179852415
2,181661402,182874510,2_142,62140,142,181723542
2,183105551,184180024,2_143,72670,143,183178221
2,184258028,185246510,2_144,40988,144,184299016
2,185292919,186166481,2_145,56157,145,185349076
2,186173993,187008958,2_146,43802,146,186217795
2,187051084,187912488,2_147,50384,147,187101468
2,187965150,189335496,2_148,92517,148,188057667
2,189340376,193062743,2_149,227455,149,189567831
2,193164125,193914901,2_150,63237,150,193227362
2,194034105,194638346,2_151,36130,151,194070235
2,194691387,195164365,2_152,18694,152,194710081
2,195286651,195660971,2_153,11778,153,195298429
2,195661579,196086972,2_154,29063,154,195690642
2,196096295,196412951,2_155,33536,155,196129831
2,196510636,196865067,2_156,18393,156,196529029
2,196867682,197239273,2_157,28404,157,196896086
2,197239632,197627012,2_158,24729,158,197264361
2,197662050,197954408,2_159,27408,159,197689458
2,198107158,198475586,2_160,46445,160,198153603
2,198500454,198931508,2_161,48519,161,198548973
2,199137936,199895865,2_162,66909,162,199204845
2,199968142,202529287,2_163,161812,163,200129954
2,202635796,203637982,2_164,125669,164,202761465
2,203714293,204341840,2_165,82806,165,203797099
2,204373780,204877624,2_166,42995,166,204416775
2,204878134,205062883,2_167,10557,167,204888691
2,205475566,205720429,2_168,20027,168,205495593
2,205770346,206130213,2_169,62307,169,205832653
2,206193594,206542396,2_170,37647,170,206231241
2,206578071,206945013,2_171,24018,171,206602089
2,206949280,207363528,2_172,30496,172,206979776
2,207363730,207767609,2_173,17547,173,207381277
2,207825809,208227355,2_174,32724,174,207858533
2,208329327,208711486,2_175,28431,175,208357758
2,208760925,209301443,2_176,67054,176,208827979
2,209342400,209953000,2_177,77255,177,209419655
2,209997496,210647380,2_178,44877,178,210042373
2,210745365,211538121,2_179,99498,179,210844863
2,211589134,212246914,2_180,47807,180,211636941
2,212320909,212824186,2_181,66573,181,212387482
2,212852717,213326409,2_182,35341,182,212888058
2,213342289,213680708,2_183,22316,183,213364605
2,213764579,214149341,2_184,31485,184,213796064
2,214153114,214507683,2_185,18829,185,214171943
2,214507919,214853179,2_186,27937,186,214535856
2,214854580,215136190,2_187,34585,187,214889165
2,215256480,215488335,2_188,21450,188,215277930
2,215513964,215766137,2_189,33867,189,215547831
2,215912646,216113898,2_190,29239,190,215941885
2,216190269,216493429,2_191,21776,191,216212045
2,216503467,216852036,2_192,44604,192,216548071
2,216884321,217230650,2_193,30166,193,216914487
2,217277393,217662614,2_194,48199,194,217325592
2,217665436,218079847,2_195,36243,195,217701679
2,218218675,218665591,2_196,49166,196,218267841
2,218735372,219251485,2_197,25640,197,218761012
2,219256821,219858767,2_198,22390,198,219279211
2,219867219,220399470,2_199,37304,199,219904523
2,220446595,220926687,2_200,41495,200,220488090
2,220979154,221372837,2_201,34602,201,221013756
2,221391482,221779496,2_202,14553,202,221406035
2,221798447,222138075,2_203,8505,203,221806952
2,222160975,222470314,2_204,20591,204,222181566
2,222537856,222731285,2_205,15550,205,222553406
2,222807437,223073842,2_206,15334,206,222822771
2,223168559,223399441,2_207,23332,207,223191891
2,223409390,223644194,2_208,7229,208,223416619
2,223719227,223978270,2_209,16223,209,223735450
2,223979340,224242207,2_210,21219,210,224000559
2,224282552,224562194,2_211,22172,211,224304724
2,224562769,224852126,2_212,14535,212,224577304
2,224878111,225162286,2_213,30996,213,224909107
2,225226591,225366587,2_214,9480,214,225236071
2,225528964,225853461,2_215,30864,215,225559828
2,225854505,226205376,2_216,12675,216,225867180
2,226253558,226619789,2_217,33640,217,226287198
2,226630526,227044832,2_218,11954,218,226642480
2,227264849,227405474,2_219,7408,219,227272257
2,227499656,227964213,2_220,32173,220,227531829
2,228005248,228431395,2_221,33056,221,228038304
2,228583338,228941815,2_222,22693,222,228606031
2,228971042,229419922,2_223,37240,223,229008282
2,229433159,229854198,2_224,49766,224,229482925
2,229898695,230248315,2_225,37698,225,229936393
2,230290646,230651817,2_226,39106,226,230329752
2,230697346,230996064,2_227,21132,227,230718478
2,231113777,231283828,2_228,11347,228,231125124
2,231332889,231603578,2_229,18899,229,231351788
2,231659791,231840220,2_230,3924,230,231663715
2,231904615,232112128,2_231,22414,231,231927029
2,232159884,232391539,2_232,38539,232,232198423
2,232391672,232599106,2_233,38862,233,232430534
2,232636206,232839547,2_234,15205,234,232651411
2,232876563,233013702,2_235,24148,235,232900711
2,233101181,233257165,2_236,20489,236,233121670
2,233259152,233439136,2_237,13168,237,233272320
2,233468862,233635747,2_238,26241,238,233495103
2,233672809,233802976,2_239,33050,239,233705859
2,233884202,234015524,2_240,10058,240,233894260
2,234015922,234192300,2_241,14927,241,234030849
2,234206021,234266606,2_242,14746,242,234220767
2,234399743,234537878,2_243,25253,243,234424996
2,234571296,234716536,2_244,6126,244,234577422
2,234717481,234853989,2_245,13694,245,234731175
2,234911148,235008652,2_246,8378,246,234919526
2,235063783,235226467,2_247,12850,247,235076633
2,235265064,235383894,2_248,15620,248,235280684
2,235425848,235521659,2_249,33542,249,235459390
2,235692748,235710012,2_250,4119,250,235696867
2,235781856,235888312,2_251,11746,251,235793602
2,235922704,236052962,2_252,20813,252,235943517
2,236178975,236240795,2_253,9581,253,236188556
2,236245253,236413403,2_254,27272,254,236272525
2,236413745,236487796,2_255,6429,255,236420174
2,236599484,236751980,2_256,26602,256,236626086
2,236753758,236889302,2_257,12195,257,236765953
2,236964096,236974800,2_258,5624,258,236969720
3,10721,10943,3_-4,0,-4,10721
3,32164,46471,3_-3,0,-3,32164
3,309281,309281,3_-2,0,-2,309281
3,493424,602360,3_0,9725,0,503149
3,688482,692231,3_1,2066,1,690548
3,1081778,1106971,3_3,547,3,1082325
3,1213096,1261847,3_4,3346,4,1216442
3,1289855,1410084,3_5,18153,5,1308008
3,1465074,1570909,3_6,29288,6,1494362
3,1596439,1725337,3_7,52202,7,1648641
3,1777030,1884729,3_8,10347,8,1787377
3,1900931,2003224,3_9,16317,9,1917248
3,2060908,2212453,3_10,38794,10,2099702
3,2212614,2306667,3_11,6278,11,2218892
3,2445533,2526000,3_12,8065,12,2453598
3,2568692,2683818,3_13,4184,13,2572876
3,2683833,2817845,3_14,22338,14,2706171
3,2874818,2956996,3_15,14835,15,2889653
3,3027957,3125938,3_16,8772,16,3036729
3,3201627,3312451,3_17,7412,17,3209039
3,3374099,3478154,3_18,26702,18,3400801
3,3478926,3561591,3_19,13172,19,3492098
3,3692479,3751061,3_20,11671,20,3704150
3,3820434,3924921,3_21,23845,21,3844279
3,3985707,4064825,3_22,2301,22,3988008
3,4135216,4206200,3_23,16387,23,4151603
3,4333593,4444499,3_24,18792,24,4352385
3,4445165,4577961,3_25,23501,25,4468666
3,4635916,4763672,3_26,25210,26,4661126
3,4834484,4896196,3_27,4181,27,4838665
3,5044781,5044781,3_28,0,28,5044781
3,5284880,5438230,3_30,12316,30,5297196
3,5438353,5596419,3_31,24262,31,5462615
3,5668598,5776608,3_32,4089,32,5672687
3,5776903,5887710,3_33,10045,33,5786948
3,5947366,6101094,3_34,18226,34,5965592
3,6164378,6171418,3_35,2816,35,6167194
3,6292329,6437104,3_36,8628,36,6300957
3,6516244,6641384,3_37,14402,37,6530646
3,6641986,6805513,3_38,14403,38,6656389
3,6922948,6977537,3_39,12767,39,6935715
3,7081776,7137164,3_40,6443,40,7088219
3,7202421,7280437,3_41,7044,41,7209465
3,7405242,7523102,3_42,14359,42,7419601
3,7600045,7689474,3_43,4406,43,7604451
3,7773017,7865553,3_44,0,44,7773017
3,7937640,8089056,3_45,5104,45,7942744
3,8119100,8275636,3_46,25948,46,8145048
3,8299898,8456176,3_47,9899,47,8309797
3,8538339,8672470,3_48,12646,48,8550985
3,8699344,8878435,3_49,27171,49,8726515
3,8878589,9070860,3_50,21776,50,8900365
3,9109394,9276506,3_51,5516,51,9114910
3,9290673,9462556,3_52,24137,52,9314810
3,9579813,9589750,3_53,9217,53,9589030
3,9705285,9881384,3_54,40347,54,9745632
3,9934302,10097739,3_55,12979,55,9947281
3,10140104,10330542,3_56,17664,56,10157768
3,10365952,10531148,3_57,7432,57,10373384
3,10555346,10686240,3_58,7740,58,10563086
3,10843474,11006579,3_59,6318,59,10849792
3,11006805,11232514,3_60,4609,60,11011414
3,11397420,11448518,3_61,11219,61,11408639
3,11529244,11650845,3_62,13754,62,11542998
3,11726038,11898200,3_63,3244,63,11729282
3,11991741,12194132,3_64,19053,64,12010794
3,12275613,12426714,3_65,15025,65,12290638
3,12526331,12646015,3_66,20750,66,12547081
3,12826347,12990073,3_67,2242,67,12828589
3,13068158,13281026,3_68,9444,68,13077602
3,13312122,13541243,3_69,27274,69,13339396
3,13588858,13873837,3_70,34518,70,13623376
3,13919861,14130756,3_71,4751,71,13924612
3,14225746,14471298,3_72,26147,72,14251893
3,14579172,14840619,3_73,6076,73,14585248
3,14840881,15185642,3_74,30850,74,14871731
3,15212599,15518003,3_75,24682,75,15237281
3,15600833,15913794,3_76,6075,76,15606908
3,16030320,16313566,3_77,9954,77,16040274
3,16316788,16718824,3_78,15225,78,16332013
3,16856587,17116402,3_79,15630,79,16872217
3,17167819,17634967,3_80,26196,80,17194015
3,17636001,18078301,3_81,40371,81,17676372
3,18156830,18640127,3_82,17298,82,18174128
3,18803152,19166746,3_83,9555,83,18812707
3,19246889,19829488,3_84,50340,84,19297229
3,19832307,20461152,3_85,38923,85,19871230
3,20521754,21167142,3_86,31213,86,20552967
3,21259912,22014570,3_87,36652,87,21296564
3,22127600,22912799,3_88,23765,88,22151365
3,22956539,23956994,3_89,46846,89,23003385
3,24095476,25243272,3_90,34104,90,24129580
3,25309804,26455561,3_91,46159,91,25355963
3,27551912,28639331,3_92,42516,92,27594428
3,28663802,30570291,3_93,94898,93,28758700
3,30892166,33259655,3_94,115746,94,31007912
3,33477053,36006439,3_95,87381,95,33564434
3,36182043,39392612,3_96,114765,96,36296808
3,39456071,44046993,3_97,144301,97,39600372
3,44061723,51695220,3_98,206795,98,44268518
3,51705143,60949356,3_99,246907,99,51952050
3,61342376,103326467,3_100,546227,100,61888603
3,71261191,109816468,3_101,509769,101,71770960
3,80654023,113602587,3_102,539071,102,81193094
3,113646252,116516668,3_103,70493,103,113716745
3,116981223,120166561,3_104,53188,104,117034411
3,120302403,124017659,3_105,94291,105,120396694
3,124116067,129308673,3_106,202747,106,124318814
3,129425959,133209088,3_107,98303,107,129524262
3,133310017,135757542,3_108,106467,108,133416484
3,135837741,137788703,3_109,73543,109,135911284
3,138000985,139906871,3_110,81414,110,138082399
3,140022349,141742536,3_111,92672,111,140115021
3,141835381,143233532,3_112,58328,112,141893709
3,143605595,144947457,3_113,66175,113,143671770
3,145175985,146374734,3_114,87844,114,145263829
3,146437321,147678608,3_115,80392,115,146517713
3,147745920,149000951,3_116,57068,116,147802988
3,149098007,150172889,3_117,37335,117,149135342
3,150265820,151357074,3_118,36195,118,150302015
3,151580947,152580559,3_119,36535,119,151617482
3,152775278,153856858,3_120,38983,120,152814261
3,153857047,154981386,3_121,57766,121,153914813
3,155094066,156073359,3_122,47472,122,155141538
3,156149346,157093371,3_123,60844,123,156210190
3,157205948,158089646,3_124,22340,124,157228288
3,158200193,158976811,3_125,28525,125,158228718
3,159377575,160086895,3_126,36072,126,159413647
3,160303648,161090715,3_127,39783,127,160343431
3,161251760,162105676,3_128,52062,128,161303822
3,162175008,163115279,3_129,64086,129,162239094
3,163193000,163999447,3_130,16964,130,163209964
3,164173791,165023796,3_131,49046,131,164222837
3,165054123,165963322,3_132,54262,132,165108385
3,165985384,166826741,3_133,77262,133,166062646
3,166997365,167747198,3_134,40122,134,167037487
3,167788820,168526552,3_135,56430,135,167845250
3,168696685,169380385,3_136,54329,136,168751014
3,169519768,170145847,3_137,54197,137,169573965
3,170222399,170939640,3_138,57673,138,170280072
3,171020937,171646803,3_139,32684,139,171053621
3,171703518,172382529,3_140,47171,140,171750689
3,172415028,173023268,3_141,47306,141,172462334
3,173135620,173741955,3_142,41165,142,173176785
3,173795508,174371181,3_143,20427,143,173815935
3,174461797,174909451,3_144,27167,144,174488964
3,175095749,175636405,3_145,53008,145,175148757
3,175686182,176071063,3_146,33422,146,175719604
3,176257656,176816753,3_147,57172,147,176314828
3,177019165,177393716,3_148,13825,148,177032990
3,177420576,177834983,3_149,22726,149,177443302
3,177994862,178413838,3_150,46892,150,178041754
3,178528159,178990141,3_151,20611,151,178548770
3,179072589,179518378,3_152,35192,152,179107781
3,179542505,180007626,3_153,38515,153,179581020
3,180034392,180519190,3_154,19561,154,180053953
3,180569854,180979842,3_155,46224,155,180616078
3,181001788,181280337,3_156,19234,156,181021022
3,181506027,181912174,3_157,40290,157,181546317
3,182041264,182427125,3_158,23691,158,182064955
3,182471766,182853665,3_159,42449,159,182514215
3,182986176,183324900,3_160,14290,160,183000466
3,183378651,183819039,3_161,27279,161,183405930
3,183842938,184314337,3_162,41402,162,183884340
3,184358036,184683602,3_163,13992,163,184372028
3,184810151,185274189,3_164,19591,164,184829742
3,185306924,185763712,3_165,31476,165,185338400
3,185794361,186274646,3_166,71138,166,185865499
3,186375496,186726226,3_167,39629,167,186415125
3,186778421,187292713,3_168,50758,168,186829179
3,187323815,187812547,3_169,69325,169,187393140
3,187894151,188340303,3_170,32773,170,187926924
3,188375234,188899082,3_171,23645,171,188398879
3,188906755,189463506,3_172,16548,172,188923303
3,189463530,190009562,3_173,48147,173,189511677
3,190062979,190589213,3_174,26332,174,190089311
3,190749467,191176436,3_175,43563,175,190793030
3,191183055,191767310,3_176,45917,176,191228972
3,191769129,192324027,3_177,40166,177,191809295
3,192401369,192780219,3_178,17144,178,192418513
3,193111248,193474429,3_179,12249,179,193123497
3,193566605,194122208,3_180,48101,180,193614706
3,194170201,194633927,3_181,20161,181,194190362
3,194718891,195268680,3_182,46855,182,194765746
3,195295230,195787729,3_183,46694,183,195341924
3,195882038,196363426,3_184,68013,184,195950051
3,196430996,196945970,3_185,41050,185,196472046
3,197015988,197523278,3_186,39768,186,197055756
3,197636012,198047709,3_187,25062,187,197661074
3,198214924,198604859,3_188,29994,188,198244918
3,198666846,199109779,3_189,18179,189,198685025
3,199231185,199665075,3_190,55901,190,199287086
3,199749302,200220852,3_191,40062,191,199789364
3,200284563,200760257,3_192,27503,192,200312066
3,200876048,201302488,3_193,37345,193,200913393
3,201302628,201799264,3_194,43548,194,201346176
3,201896106,202367429,3_195,48376,195,201944482
3,202432589,202905914,3_196,36759,196,202469348
3,202928647,203365471,3_197,15955,197,202944602
3,203450155,203895151,3_198,25597,198,203475752
3,204072213,204476100,3_199,46210,199,204118423
3,204578494,204991831,3_200,26532,200,204605026
3,204996823,205486412,3_201,32275,201,205029098
3,205488930,205973799,3_202,25196,202,205514126
3,206013584,206417171,3_203,17950,203,206031534
3,206477546,206919571,3_204,42992,204,206520538
3,206919617,207306868,3_205,41678,205,206961295
3,207395226,207774046,3_206,31334,206,207426560
3,207892841,208174352,3_207,31815,207,207924656
3,208266684,208629130,3_208,40977,208,208307661
3,208629470,209013734,3_209,21107,209,208650577
3,209022114,209338676,3_210,17474,210,209039588
3,209487389,209739869,3_211,21290,211,209508679
3,209798662,210135054,3_212,30857,212,209829519
3,210137986,210430174,3_213,20910,213,210158896
3,210505830,210822399,3_214,27346,214,210533176
3,210846035,211149998,3_215,19184,215,210865219
3,211228576,211397410,3_216,11605,216,211240181
3,211533834,211849415,3_217,14797,217,211548631
3,211849671,212183609,3_218,19182,218,211868853
3,212193036,212503755,3_219,21339,219,212214375
3,212549593,212838402,3_220,16016,220,212565609
3,212970606,213016899,3_221,3471,221,212974077
3,213258179,213474296,3_222,8249,222,213266428
3,213520712,213805342,3_223,31755,223,213552467
3,213839812,214123437,3_224,13196,224,213853008
3,214175686,214487159,3_225,17238,225,214192924
3,214643436,214830093,3_226,10529,226,214653965
3,214853751,215089614,3_227,13241,227,214866992
3,215170305,215484093,3_228,32419,228,215202724
3,215527734,215787966,3_229,23234,229,215550968
3,215847795,216133321,3_230,18800,230,215866595
3,216233130,216483774,3_231,52019,231,216285149
3,216522733,216801711,3_232,24257,232,216546990
3,216839946,217147754,3_233,25811,233,216865757
3,217160164,217470947,3_234,18747,234,217178911
3,217549925,217810558,3_235,46581,235,217596506
3,217818682,218121086,3_236,36194,236,217854876
3,218175840,218362227,3_237,36731,237,218212571
3,218480725,218794146,3_238,24970,238,218505695
3,218794271,219116527,3_239,18142,239,218812413
3,219124977,219426628,3_240,37102,240,219162079
3,219461735,219771078,3_241,28780,241,219490515
3,219779032,220032739,3_242,13530,242,219792562
3,220130092,220426637,3_243,24417,243,220154509
3,220442190,220769447,3_244,59357,244,220501547
3,220846407,220984058,3_245,10189,245,220856596
3,221154644,221440489,3_246,36543,246,221191187
3,221502356,221764351,3_247,61323,247,221563679
3,221790457,222060200,3_248,17040,248,221807497
3,222406658,222471067,3_249,9856,249,222416514
3,222479769,222822311,3_250,27743,250,222507512
3,222892773,223176225,3_251,19847,251,222912620
3,223177315,223414679,3_252,16319,252,223193634
3,223535485,223844412,3_253,73426,253,223608911
3,223959238,224170472,3_254,45972,254,224005210
3,224271650,224605677,3_255,24324,255,224295974
3,224606923,224944200,3_256,25865,256,224632788
3,225003781,225333541,3_257,33357,257,225037138
3,225333852,225605495,3_258,16381,258,225350233
3,225707090,226068574,3_259,30676,259,225737766
3,226132213,226420453,3_260,23811,260,226156024
3,226477302,226809265,3_261,32944,261,226510246
3,226815960,227191773,3_262,18757,262,226834717
3,227192173,227495785,3_263,36595,263,227228768
3,227578705,227939947,3_264,29200,264,227607905
3,227950288,228275862,3_265,10746,265,227961034
3,228369552,228669583,3_266,19956,266,228389508
3,228719598,229091440,3_267,24969,267,228744567
3,229132810,229432228,3_268,39202,268,229172012
3,229487051,229868105,3_269,42316,269,229529367
3,229871743,230256015,3_270,84384,270,229956127
3,230322393,230652477,3_271,33268,271,230355661
3,230652711,231005252,3_272,42903,272,230695614
3,231057014,231385554,3_273,20030,273,231077044
3,231476019,231829189,3_274,15350,274,231491369
3,231866374,232096313,3_275,22645,275,231889019
4,30681,378949,4_0,15692,0,46373
4,513174,1184604,4_1,53931,1,567105
4,1189483,1550273,4_2,24349,2,1213832
4,1881294,1917256,4_3,2531,3,1883825
4,1938067,2118203,4_4,26938,4,1965005
4,2262612,2352617,4_5,6557,5,2269169
4,2381942,2526353,4_6,20339,6,2402281
4,2594753,2682294,4_7,17742,7,2612495
4,2682355,2818125,4_8,13108,8,2695463
4,2830809,2926230,4_9,11400,9,2842209
4,2978444,3047983,4_10,13040,10,2991484
4,3132694,3147957,4_11,0,11,3132694
4,3211846,3267151,4_12,14710,12,3226556
4,3408350,3482699,4_14,19739,14,3428089
4,3512135,3589265,4_15,1953,15,3514088
4,3591573,3620272,4_16,2712,16,3594285
4,3739443,3761128,4_17,8620,17,3748063
4,3784020,3784938,4_18,0,18,3784020
4,3888774,3934423,4_19,8862,19,3897636
4,4053634,4109783,4_21,17496,21,4071130
4,4192099,4214058,4_22,5215,22,4197314
4,4244290,4273344,4_23,789,23,4245079
4,4317994,4325882,4_24,2636,24,4320630
4,4394357,4477843,4_25,5430,25,4399787
4,4477934,4550552,4_26,8743,26,4486677
4,4600628,4622276,4_27,6986,27,4607614
4,4660231,4724295,4_28,4129,28,4664360
4,4734897,4796446,4_29,12135,29,4747032
4,4834455,4896289,4_30,20015,30,4854470
4,4908245,4988659,4_31,831,31,4909076
4,4996787,5075762,4_32,10062,32,5006849
4,5086523,5172337,4_33,11997,33,5098520
4,5192271,5262259,4_34,11411,34,5203682
4,5265647,5315927,4_35,1551,35,5267198
4,5367199,5418760,4_36,18588,36,5385787
4,5454831,5544579,4_37,19252,37,5474083
4,5555860,5604978,4_38,1390,38,5557250
4,5666409,5709695,4_39,10695,39,5677104
4,5786578,5843016,4_40,7563,40,5794141
4,5881025,5973676,4_41,7164,41,5888189
4,5979743,6074745,4_42,8543,42,5988286
4,6095289,6110501,4_43,9235,43,6104524
4,6369851,6459398,4_45,22657,45,6392508
4,6480370,6613499,4_46,13730,46,6494100
4,6624898,6687856,4_47,264,47,6625162
4,6852429,6856110,4_48,478,48,6852907
4,6941141,7018149,4_49,3309,49,6944450
4,7133365,7313492,4_50,8060,50,7141425
4,7431560,7567242,4_51,2493,51,7434053
4,7617500,7710491,4_52,1380,52,7618880
4,8232096,8232096,4_54,0,54,8232096
4,8896580,9354162,4_55,4137,55,8900717
4,9485353,10312489,4_56,68078,56,9553431
4,10343443,10911945,4_57,28023,57,10371466
4,10945470,11391798,4_58,22861,58,10968331
4,11408713,11707139,4_59,9336,59,11418049
4,11814349,12083631,4_60,20170,60,11834519
4,12109753,12262261,4_61,2506,61,12112259
4,12443362,12654993,4_62,4492,62,12447854
4,12685857,12940718,4_63,11346,63,12697203
4,12945992,13167156,4_64,23472,64,12969464
4,13305435,13398806,4_65,3764,65,13309199
4,13688180,13728572,4_66,0,66,13688180
4,13770253,13971779,4_67,10512,67,13780765
4,14037519,14239177,4_68,15315,68,14052834
4,14344975,14574161,4_69,14432,69,14359407
4,14628871,14950486,4_70,28050,70,14656921
4,14950589,15304936,4_71,7712,71,14958301
4,15395629,15827652,4_72,17991,72,15413620
4,15859514,16426358,4_73,20196,73,15879710
4,16497245,17096116,4_74,23367,74,16520612
4,17141444,17742644,4_75,32337,75,17173781
4,17768030,18222609,4_76,12490,76,17780520
4,18370385,18694381,4_77,25576,77,18395961
4,18809334,19011685,4_78,15462,78,18824796
4,19111471,19440255,4_79,27192,79,19138663
4,19551172,19621847,4_80,17899,80,19569071
4,19845875,20104159,4_81,11284,81,19857159
4,20175629,20411257,4_82,8035,82,20183664
4,20501505,20777312,4_83,9360,83,20510865
4,20940553,21136656,4_84,4051,84,20944604
4,21137136,21431932,4_85,9662,85,21146798
4,21581970,21914859,4_86,16971,86,21598941
4,22103534,22359837,4_87,9934,87,22113468
4,22525691,23073749,4_88,18592,88,22544283
4,23131990,27707804,4_89,232026,89,23364016
4,27751687,29052182,4_90,75341,90,27827028
4,29116714,30544275,4_91,60469,91,29177183
4,30764980,34667221,4_92,181789,92,30946769
4,34801231,35348565,4_93,23751,93,34824982
4,35541802,36132987,4_94,32056,94,35573858
4,36166382,36554950,4_95,38524,95,36204906
4,36724591,37259880,4_96,51856,96,36776447
4,37297448,43488405,4_97,311663,97,37609111
4,38021766,45272090,4_98,328199,98,38349965
4,39318564,46360181,4_99,258136,99,39576700
4,46431071,55759885,4_100,240313,100,46671384
4,47535652,56499080,4_101,238448,101,47774100
4,56859627,57448129,4_102,6791,102,56866418
4,57810601,57947832,4_103,1510,103,57812111
4,58266323,58814387,4_104,15976,104,58282299
4,58953037,59298773,4_105,8918,105,58961955
4,59678694,60367706,4_106,12384,106,59691078
4,60514651,67494894,4_107,211881,107,60726532
4,61718593,78307304,4_108,475925,108,62194518
4,69841830,79758393,4_109,258050,109,70099880
4,79840897,113443101,4_110,478287,110,80319184
4,80938195,142703795,4_111,1110193,111,82048388
4,82170551,145030054,4_112,1143101,112,83313652
4,145181333,146706508,4_113,73554,113,145254887
4,146938357,148493728,4_114,53743,114,146992100
4,148819404,150818457,4_115,60474,115,148879878
4,150850777,153049691,4_116,89677,116,150940454
4,153195266,154430277,4_117,66063,117,153261329
4,154587972,155382020,4_118,37793,118,154625765
4,155527242,156027643,4_119,22199,119,155549441
4,156069814,156549198,4_120,28871,120,156098685
4,156635269,157118996,4_121,50735,121,156686004
4,157167986,157555795,4_122,19226,122,157187212
4,157609701,158029245,4_123,20998,123,157630699
4,158029351,158454077,4_124,29872,124,158059223
4,158490152,158866479,4_125,26565,125,158516717
4,158890353,159298066,4_126,26344,126,158916697
4,159401229,159759975,4_127,19361,127,159420590
4,159781409,160270871,4_128,34695,128,159816104
4,160277454,160571835,4_129,17970,129,160295424
4,160926829,161413245,4_130,50168,130,160976997
4,161498615,162078066,4_131,20914,131,161519529
4,162146750,162934412,4_132,75339,132,162222089
4,163046077,164270809,4_133,116635,133,163162712
4,164286772,166367637,4_134,102289,134,164389061
4,166774346,168183301,4_135,68768,135,166843114
4,168545321,169618616,4_136,107484,136,168652805
4,169800433,170521450,4_137,57371,137,169857804
4,170650398,171216637,4_138,42790,138,170693188
4,171256912,171844949,4_139,94972,139,171351884
4,171850493,172356153,4_140,41414,140,171891907
4,172427797,172836510,4_141,44390,141,172472187
4,172992976,173432990,4_142,51351,142,173044327
4,173474913,173932298,4_143,38454,143,173513367
4,173995167,174303214,4_144,22039,144,174017206
4,174463559,174917095,4_145,32370,145,174495929
4,174955269,175383054,4_146,39079,146,174994348
4,175497507,175760187,4_147,60032,147,175557539
4,175913407,176165468,4_148,25216,148,175938623
4,176357382,176738135,4_149,15408,149,176372790
4,176804624,177152493,4_150,36886,150,176841510
4,177229440,177606373,4_151,23409,151,177252849
4,177630621,178038992,4_152,22134,152,177652755
4,178039519,178390697,4_153,25096,153,178064615
4,178454005,178789552,4_154,44422,154,178498427
4,178820932,179084841,4_155,6829,155,178827761
4,179599403,179822919,4_157,35279,157,179634682
4,180074964,180252835,4_158,23224,158,180098188
4,180266670,180582008,4_159,20002,159,180286672
4,180623420,180892264,4_160,17972,160,180641392
4,181057533,181339676,4_161,17500,161,181075033
4,181349247,181728755,4_162,26223,162,181375470
4,181772210,182128992,4_163,35478,163,181807688
4,182179566,182567373,4_164,14201,164,182193767
4,182589218,183033222,4_165,38825,165,182628043
4,183041811,183589929,4_166,52787,166,183094598
4,183590078,184179280,4_167,65647,167,183655725
4,184276560,185082847,4_168,69877,168,184346437
4,185097795,186198067,4_169,96215,169,185194010
4,186323346,187465686,4_170,106641,170,186429987
4,187594551,188388343,4_171,48197,171,187642748
4,188389044,189107731,4_172,38102,172,188427146
4,189151239,189635710,4_173,25095,173,189176334
4,189805975,190269240,4_174,17498,174,189823473
4,190335776,190683341,4_175,17190,175,190352966
4,190825971,191272797,4_176,49479,176,190875450
4,191273829,191764922,4_177,24224,177,191298053
4,191768322,192257556,4_178,28884,178,191797206
4,192583037,192871394,4_179,11944,179,192594981
4,192917031,193611985,4_180,27882,180,192944913
4,193729003,195014525,4_181,47215,181,193776218
4,195035542,199183306,4_182,313631,182,195349173
4,199216720,199845162,4_183,32100,183,199248820
4,199914229,200448975,4_184,26821,184,199941050
4,200475319,200877341,4_185,47317,185,200522636
4,200964421,201348037,4_186,18868,186,200983289
4,201452760,201876567,4_187,29188,187,201481948
4,201887590,202276876,4_188,15992,188,201903582
4,202424217,202889287,4_189,23034,189,202447251
4,203131171,213138936,4_190,396799,190,203527970
4,203705294,214651172,4_191,415114,191,204120408
4,205377214,216292061,4_192,390768,192,205767982
4,216317960,217694281,4_193,60336,193,216378296
4,217912761,219369241,4_194,71739,194,217984500
4,219481561,223936270,4_195,169493,195,219651054
4,224036341,225570270,4_196,61062,196,224097403
4,225687480,226459735,4_197,39490,197,225726970
4,226549106,227214533,4_198,22468,198,226571574
4,227273225,227889672,4_199,22125,199,227295350
4,227943670,228556361,4_200,24824,200,227968494
4,228618784,229182439,4_201,45855,201,228664639
4,229309573,230217272,4_202,56129,202,229365702
4,230315010,232780894,4_203,156198,203,230471208
4,232802983,233720975,4_204,99587,204,232902570
4,233757906,234120112,4_205,43475,205,233801381
4,234187806,234499489,4_206,30882,206,234218688
4,234500967,234737275,4_207,33232,207,234534199
4,234789235,234956372,4_208,36170,208,234825405
4,235002677,235165482,4_209,6518,209,235009195
4,235199838,235364503,4_210,26751,210,235226589
4,235381079,235466107,4_211,19774,211,235400853
4,235546802,235693646,4_212,19684,212,235566486
4,235704081,235826603,4_213,18663,213,235722744
4,235880642,235880642,4_214,0,214,235880642
4,236012843,236114155,4_215,16021,215,236028864
4,236160554,236264030,4_216,21679,216,236182233
4,236297169,236393611,4_217,41718,217,236338887
4,236394335,236484662,4_218,12295,218,236406630
4,236525898,236572053,4_219,9894,219,236535792
4,236679369,236764605,4_220,10663,220,236690032
4,236858006,236883797,4_221,15642,221,236873648
4,236885537,236977323,4_222,41836,222,236927373
4,237027439,237046105,4_223,13560,223,237040999
4,237135980,237150138,4_224,4559,224,237140539
4,237258383,237323479,4_225,29048,225,237287431
4,237370728,237458146,4_226,21999,226,237392727
4,237483421,237524347,4_227,20593,227,237504014
4,237589631,237684110,4_228,24439,228,237614070
4,237684222,237779729,4_229,14629,229,237698851
4,237868425,237908077,4_230,4185,230,237872610
4,237909035,238008554,4_231,21882,231,237930917
4,238040516,238123101,4_232,6919,232,238047435
4,238163745,238229348,4_233,15231,233,238178976
4,238275377,238359730,4_234,45636,234,238321013
4,238361417,238473894,4_235,35344,235,238396761
4,238474295,238559710,4_236,8996,236,238483291
4,238636716,238638910,4_237,0,237,238636716
4,238738885,238768073,4_238,8660,238,238747545
4,238876139,238936067,4_239,9580,239,238885719
4,238951487,239021719,4_240,23713,240,238975200
4,239073855,239158373,4_241,34914,241,239108769
4,239206305,239251520,4_242,10817,242,239217122
4,239323353,239435813,4_243,30283,243,239353636
4,239436529,239522401,4_244,26660,244,239463189
4,239623771,239689462,4_245,19047,245,239642818
4,239689655,239816313,4_246,31798,246,239721453
4,239893275,239937028,4_247,14418,247,239907693
4,239981228,240072490,4_248,22570,248,240003798
4,240086886,240194744,4_249,21049,249,240107935
4,240210635,240337897,4_250,23526,250,240234161
4,240411949,240473883,4_251,19994,251,240431943
4,240522315,240578673,4_252,5983,252,240528298
4,240611033,240740775,4_253,7584,253,240618617
4,240741368,240844289,4_254,31720,254,240773088
4,240995804,241003102,4_255,325,255,240996129
4,241014721,241132237,4_256,7038,256,241021759
4,241234728,241241481,4_257,4101,257,241238829
4,241391540,241391540,4_258,0,258,241391540
5,981,110167,5_6,37951,6,38932
5,236202,436077,5_7,9752,7,245954
5,441509,672691,5_8,23488,8,464997
5,681595,900522,5_9,63159,9,744754
5,903498,1130633,5_10,78829,10,982327
5,1137706,1357125,5_11,43993,11,1181699
5,1357401,1577021,5_12,50040,12,1407441
5,1580174,1789380,5_13,38557,13,1618731
5,1814333,1981554,5_14,38816,14,1853149
5,2106584,2189946,5_15,36790,15,2143374
5,2209681,2388511,5_16,41633,16,2251314
5,2389819,2569594,5_17,22016,17,2411835
5,2574249,2747310,5_18,28732,18,2602981
5,2748540,2884736,5_19,34915,19,2783455
5,2923444,3072179,5_20,21093,20,2944537
5,3084384,3208347,5_21,25629,21,3110013
5,3257374,3353354,5_22,12163,22,3269537
5,3393518,3505334,5_23,18220,23,3411738
5,3529947,3668314,5_24,35001,24,3564948
5,3668784,3789040,5_25,20442,25,3689226
5,3807290,3936750,5_26,14162,26,3821452
5,3937872,4039573,5_27,24433,27,3962305
5,4095307,4160973,5_28,5946,28,4101253
5,4197386,4314011,5_29,41700,29,4239086
5,4316131,4430827,5_30,24904,30,4341035
5,4468232,4522226,5_31,14384,31,4482616
5,4570629,4679163,5_32,36756,32,4607385
5,4685046,4786429,5_33,14271,33,4699317
5,4874690,4917092,5_34,430,34,4875120
5,4918065,5035169,5_35,5371,35,4923436
5,5052062,5118742,5_36,8901,36,5060963
5,5181914,5254563,5_37,21004,37,5202918
5,5287519,5384550,5_38,10019,38,5297538
5,5423602,5497963,5_39,4987,39,5428589
5,5544105,5638297,5_40,24513,40,5568618
5,5749772,5750556,5_41,569,41,5750341
5,5771612,5892654,5_42,23575,42,5795187
5,5897822,5943859,5_43,17032,43,5914854
5,6049063,6157738,5_44,11937,44,6061000
5,6167452,6278770,5_45,0,45,6167452
5,6303304,6446163,5_46,32981,46,6336285
5,6452883,6577975,5_47,24168,47,6477051
5,6607649,6691072,5_48,13216,48,6620865
5,6776522,6921294,5_49,28298,49,6804820
5,6922366,7002242,5_50,12347,50,6934713
5,7109794,7292920,5_51,58804,51,7168598
5,7295968,7462753,5_52,17738,52,7313706
5,7518770,7727939,5_53,33595,53,7552365
5,7764410,7986469,5_54,19291,54,7783701
5,7995503,8260078,5_55,20054,55,8015557
5,8260790,8550785,5_56,28928,56,8289718
5,8612740,8833341,5_57,19202,57,8631942
5,8932116,9191992,5_58,16733,58,8948849
5,9244631,9474943,5_59,23448,59,9268079
5,9525613,9813160,5_60,32694,60,9558307
5,9814865,10092389,5_61,31478,61,9846343
5,10100701,10281321,5_62,20287,62,10120988
5,10400371,10588115,5_63,15822,63,10416193
5,10622792,10859555,5_64,22333,64,10645125
5,10859853,11085788,5_65,29549,65,10889402
5,11087676,11087676,5_66,0,66,11087676
5,11344404,11518926,5_67,24557,67,11368961
5,11526880,11724618,5_68,14751,68,11541631
5,11773810,11928850,5_69,15412,69,11789222
5,11939108,12072557,5_70,22136,70,11961244
5,12150936,12310646,5_71,35182,71,12186118
5,12364335,12559634,5_72,18586,72,12382921
5,12560018,12707020,5_73,13810,73,12573828
5,12834037,12972312,5_74,7271,74,12841308
5,13047295,13194136,5_75,11507,75,13058802
5,13227416,13428075,5_76,27910,76,13255326
5,13503683,13666209,5_77,31011,77,13534694
5,13669534,13894963,5_78,15532,78,13685066
5,13945828,14179317,5_79,23239,79,13969067
5,14181395,14437668,5_80,20976,80,14202371
5,14468037,14754441,5_81,20358,81,14488395
5,14755066,14926826,5_82,17447,82,14772513
5,15076523,15397520,5_83,45364,83,15121887
5,15433846,15774138,5_84,38306,84,15472152
5,15799989,16171128,5_85,13256,85,15813245
5,16209002,16617480,5_86,32532,86,16241534
5,16618237,17067479,5_87,13523,87,16631760
5,17226125,17633537,5_88,28174,88,17254299
5,17683123,18379883,5_89,28326,89,17711449
5,18381357,19462536,5_90,81372,90,18462729
5,19523947,22775579,5_91,216915,91,19740862
5,22776716,25549359,5_92,160284,92,22937000
5,25615985,30603345,5_93,193635,93,25809620
5,30704798,31697136,5_94,71660,94,30776458
5,31818841,32462340,5_95,35978,95,31854819
5,32614790,37950868,5_96,258906,96,32873696
5,33782064,39674127,5_97,250688,97,34032752
5,39798292,40563876,5_98,73483,98,39871775
5,40764828,41550564,5_99,32113,99,40796941
5,41617495,42536204,5_100,41669,100,41659164
5,42658088,51104320,5_101,283295,101,42941383
5,51326295,52421405,5_102,60664,102,51386959
5,52739949,53980722,5_103,52917,103,52792866
5,54165047,55434126,5_104,44166,104,54209213
5,55480956,56997049,5_105,77012,105,55557968
5,57187716,62858407,5_106,336069,106,57523785
5,62878670,67202255,5_107,278419,107,63157089
5,67478063,70090718,5_108,192868,108,67670931
5,70148682,76934575,5_109,348972,109,70497654
5,76935044,79537794,5_110,173667,110,77108711
5,79681034,81278299,5_111,81437,111,79762471
5,81763570,83577191,5_112,68505,112,81832075
5,83659812,125218053,5_113,773836,113,84433648
5,95406045,128462548,5_114,543482,114,95949527
5,97512129,146631381,5_115,901361,115,98413490
5,99838061,147707890,5_116,899017,116,100737078
5,147877157,148410536,5_117,16518,117,147893675
5,148605040,149222903,5_118,1844,118,148606884
5,149459706,150095491,5_119,9761,119,149469467
5,150190241,150934634,5_120,8515,120,150198756
5,151015807,152212719,5_121,36212,121,151052019
5,152392121,164123479,5_122,433110,122,152825231
5,164223250,166046856,5_123,57999,123,164281249
5,166054379,166935362,5_124,28890,124,166083269
5,166967913,167609574,5_125,31869,125,166999782
5,167613697,168089538,5_126,31830,126,167645527
5,168222668,168672811,5_127,34289,127,168256957
5,168841754,169240867,5_128,28085,128,168869839
5,169454258,169684108,5_129,13229,129,169467487
5,169778443,170256551,5_130,24427,130,169802870
5,170362133,170823448,5_131,12719,131,170374852
5,170826950,171367046,5_132,30530,132,170857480
5,171520618,171969660,5_133,25549,133,171546167
5,172015640,172620195,5_134,45490,134,172061130
5,172700557,173168729,5_135,34990,135,172735547
5,173374232,173994709,5_136,32673,136,173406905
5,174012303,174683875,5_137,73441,137,174085744
5,174794366,175376219,5_138,29725,138,174824091
5,175428110,176046990,5_139,98402,139,175526512
5,176108982,176800402,5_140,32671,140,176141653
5,176870480,177512403,5_141,29288,141,176899768
5,177634512,178364041,5_142,54309,142,177688821
5,178475204,179394385,5_143,40192,143,178515396
5,179542181,180740250,5_144,93699,144,179635880
5,180861646,182040007,5_145,103845,145,180965491
5,182040396,182900352,5_146,61606,146,182102002
5,182900855,183525560,5_147,53215,147,182954070
5,183601347,184066238,5_148,33822,148,183635169
5,184066652,184503368,5_149,42380,149,184109032
5,184656677,184743538,5_150,14990,150,184671667
5,184981962,185334897,5_151,3209,151,184985171
5,185376432,185698585,5_152,32502,152,185408934
5,185769500,186099618,5_153,11857,153,185781357
5,186110477,186420380,5_154,10955,154,186121432
5,186483786,186825358,5_155,21552,155,186505338
5,186827958,187112806,5_156,31884,156,186859842
5,187194835,187491342,5_157,19938,157,187214773
5,187657126,187887089,5_158,16152,158,187673278
5,187955995,188289926,5_159,22266,159,187978261
5,188355680,188719738,5_160,42989,160,188398669
5,188746232,189154170,5_161,32114,161,188778346
5,189199476,189623039,5_162,13219,162,189212695
5,189754196,190236988,5_163,22442,163,189776638
5,190241256,190915636,5_164,44293,164,190285549
5,190933588,191681696,5_165,61393,165,190994981
5,191715504,192581445,5_166,67515,166,191783019
5,192613116,193454204,5_167,40805,167,192653921
5,193518279,194261199,5_168,58845,168,193577124
5,194333908,195029109,5_169,28380,169,194362288
5,195095252,195688434,5_170,24882,170,195120134
5,195791958,196415245,5_171,34192,171,195826150
5,196507753,196991020,5_172,22205,172,196529958
5,197259914,197721504,5_173,19299,173,197279213
5,197778376,198317219,5_174,62722,174,197841098
5,198522909,198823891,5_175,17566,175,198540475
5,198877480,199365895,5_176,43566,176,198921046
5,199366678,199787002,5_177,38588,177,199405266
5,199939857,200226177,5_178,36560,178,199976417
5,200240286,200598912,5_179,35528,179,200275814
5,200649144,200972858,5_180,42095,180,200691239
5,201035412,201269387,5_181,32361,181,201067773
5,201342567,201633325,5_182,34159,182,201376726
5,201664671,201945703,5_183,12925,183,201677596
5,201978436,202230706,5_184,38573,184,202017009
5,202283619,202571835,5_185,28001,185,202311620
5,202606389,202827431,5_186,17462,186,202623851
5,202924999,203163807,5_187,15376,187,202940375
5,203173372,203407635,5_188,26381,188,203199753
5,203547072,203716901,5_189,60522,189,203607594
5,203782068,204024149,5_190,25249,190,203807317
5,204059831,204325602,5_191,60208,191,204120039
5,204328391,204609698,5_192,45534,192,204373925
5,204621207,204910073,5_193,36728,193,204657935
5,204911022,205184841,5_194,27748,194,204938770
5,205225075,205495365,5_195,34163,195,205259238
5,205497633,205790775,5_196,28883,196,205526516
5,205792064,206080102,5_197,18250,197,205810314
5,206142040,206362459,5_198,31336,198,206173376
5,206454182,206635869,5_199,25646,199,206479828
5,206722811,206930395,5_200,29953,200,206752764
5,206971962,207250043,5_201,32264,201,207004226
5,207276471,207519658,5_202,29286,202,207305757
5,207655470,207664940,5_203,6747,203,207662217
5,207891157,208104037,5_204,34349,204,207925506
5,208159292,208397825,5_205,31890,205,208191182
5,208427411,208695048,5_206,16515,206,208443926
5,208740255,209010035,5_207,34928,207,208775183
5,209124430,209292524,5_208,19374,208,209143804
5,209317651,209572485,5_209,8134,209,209325785
5,209670017,209875711,5_210,36284,210,209706301
5,209896867,210173902,5_211,121727,211,210018594
5,210240973,210479324,5_212,20811,212,210261784
5,210487023,210769431,5_213,32376,213,210519399
5,210769613,211039351,5_214,14579,214,210784192
5,211070605,211352030,5_215,29357,215,211099962
5,211439363,211614836,5_216,22301,216,211461664
5,211666684,211940123,5_217,43518,217,211710202
5,211942345,212237320,5_218,52206,218,211994551
5,212237858,212526097,5_219,33259,219,212271117
5,212542422,212821180,5_220,40460,220,212582882
5,212864342,213106693,5_221,23184,221,212887526
5,213119441,213400339,5_222,43888,222,213163329
5,213439275,213615298,5_223,16736,223,213456011
5,213722445,213947533,5_224,23522,224,213745967
5,214051075,214285260,5_225,45469,225,214096544
5,214285431,214538433,5_226,59163,226,214344594
5,214612819,214852173,5_227,22013,227,214634832
5,214898439,215077527,5_228,35106,228,214933545
5,215222288,215444451,5_229,36941,229,215259229
5,215467994,215714323,5_230,63444,230,215531438
5,215781772,215994747,5_231,63768,231,215845540
5,216072837,216309937,5_232,36924,232,216109761
5,216381186,216622476,5_233,68666,233,216449852
5,216640892,216877482,5_234,30968,234,216671860
5,216950438,217160492,5_235,7254,235,216957692
5,217275347,217449422,5_236,8456,236,217283803
5,217536190,217756971,5_237,16692,237,217552882
5,217808337,217833870,5_238,1462,238,217809799
6,120318,371184,6_1,21089,1,141407
6,475683,1912328,6_2,74720,2,550403
6,1960332,2912177,6_3,63365,3,2023697
6,2992265,3648442,6_4,70280,4,3062545
6,3679213,4172204,6_5,15998,5,3695211
6,4304669,4686190,6_6,28552,6,4333221
6,4799970,5173744,6_7,27456,7,4827426
6,5278867,5683432,6_8,16084,8,5294951
6,5720373,6152535,6_9,12439,9,5732812
6,6185492,6629097,6_10,25579,10,6211071
6,6648022,7095404,6_11,23874,11,6671896
6,7110039,7623087,6_12,32039,12,7142078
6,7630900,8145317,6_13,15872,13,7646772
6,8269245,16089449,6_14,158785,14,8428030
6,9152836,17428879,6_15,167735,15,9320571
6,17575325,18923844,6_16,16957,16,17592282
6,19368059,24748284,6_17,103087,17,19471146
6,24958772,27736993,6_18,59941,18,25018713
6,27901455,28870486,6_19,39842,19,27941297
6,29003350,29984784,6_20,34681,20,29038031
6,30106592,31241281,6_21,20766,21,30127358
6,31287151,34227828,6_22,86182,22,31373333
6,34430334,37902921,6_23,110327,23,34540661
6,38065184,91354084,6_24,1556540,24,39621724
6,82765037,92168627,6_25,476079,25,83241116
6,92302819,92816050,6_26,14379,26,92317198
6,92943497,93443953,6_27,48835,27,92992332
6,93491320,93929602,6_28,33015,28,93524335
6,94093396,94763781,6_29,45317,29,94138713
6,94822113,95566093,6_30,27009,30,94849122
6,95602879,96349125,6_31,33147,31,95636026
6,96392576,96928532,6_32,56715,32,96449291
6,97058370,97637133,6_33,68996,33,97127366
6,97707204,98314157,6_34,49384,34,97756588
6,98354041,98940656,6_35,31899,35,98385940
6,99192669,103161567,6_36,187573,36,99380242
6,103321468,103625409,6_37,23233,37,103344701
6,103636332,103990535,6_38,15307,38,103651639
6,104067038,104269908,6_39,20746,39,104087784
6,104428930,104508247,6_40,16094,40,104445024
6,104668309,104866170,6_41,38901,41,104707210
6,104964777,105197427,6_42,29429,42,104994206
6,105212082,105539705,6_43,19927,43,105232009
6,105591697,105955075,6_44,14842,44,105606539
6,105988899,106469422,6_45,18290,45,106007189
6,106643494,109410986,6_46,165330,46,106808824
6,109536732,110014466,6_47,17542,47,109554274
6,110017357,110388450,6_48,10574,48,110027931
6,110416805,110671503,6_49,6848,49,110423653
6,110693372,110820468,6_50,14745,50,110708117
6,111017344,111200302,6_51,15425,51,111032769
6,111237961,111372771,6_52,7645,52,111245606
6,111465564,111679370,6_53,12149,53,111477713
6,111680275,111912258,6_54,6772,54,111687047
6,111918936,112141862,6_55,9452,55,111928388
6,112160798,112393730,6_56,16525,56,112177323
6,112433353,112687329,6_57,6918,57,112440271
6,112744969,113025592,6_58,8162,58,112753131
6,113044845,113359322,6_59,18861,59,113063706
6,113558869,114058635,6_60,32481,60,113591350
6,114081620,118096980,6_61,222800,61,114304420
6,118132543,119120141,6_62,62345,62,118194888
6,119120400,119856003,6_63,15504,63,119135904
6,119856732,120664015,6_64,70391,64,119927123
6,120674648,122666291,6_65,107916,65,120782564
6,122709594,124033186,6_66,94798,66,122804392
6,124039995,124666935,6_67,45082,67,124085077
6,124709356,125225264,6_68,42880,68,124752236
6,125241225,125641114,6_69,17282,69,125258507
6,125802347,126198489,6_70,17665,70,125820012
6,126396701,126710824,6_71,7740,71,126404441
6,126814641,127383121,6_72,21681,72,126836322
6,127437150,131214613,6_73,213934,73,127651084
6,131322759,132427723,6_74,43351,74,131366110
6,132453495,137924968,6_75,285561,75,132739056
6,133515728,140062631,6_76,364379,76,133880107
6,140161544,142661978,6_77,146686,77,140308230
6,142750698,143696195,6_78,65488,78,142816186
6,143752587,144436232,6_79,39843,79,143792430
6,144482978,145079064,6_80,37048,80,144520026
6,145188933,145831378,6_81,43535,81,145232468
6,145936858,146700478,6_82,51108,82,145987966
6,146768046,147543404,6_83,66791,83,146834837
6,147648407,148166348,6_84,52129,84,147700536
6,148183140,148597635,6_85,32598,85,148215738
6,148633328,148966297,6_86,24883,86,148658211
6,148969256,149129193,6_87,7016,87,148976272
6,149285944,149531997,6_88,15756,88,149301700
6,149533547,149725745,6_89,14338,89,149547885
6,149795072,149943922,6_90,14144,90,149809216
6,150015523,150179534,6_91,19122,91,150034645
6,150226812,150377022,6_92,15608,92,150242420
6,150424316,150590167,6_93,7754,93,150432070
6,150602105,150785775,6_94,31479,94,150633584
6,150786175,150941869,6_95,19824,95,150805999
6,151033724,151137738,6_96,12231,96,151045955
6,151207232,151246907,6_97,8768,97,151216000
6,151440796,151487300,6_98,24559,98,151465355
6,151543068,151699317,6_99,8892,99,151551960
6,151703247,151873792,6_100,19761,100,151723008
6,151927748,152088707,6_101,5155,101,151932903
6,152121235,152310372,6_102,38967,102,152160202
6,152314067,152534187,6_103,18796,103,152332863
6,152746826,152804743,6_104,1649,104,152748475
6,152845283,153093028,6_105,18608,105,152863891
6,153098222,153414548,6_106,34520,106,153132742
6,153478984,153845734,6_107,25656,107,153504640
6,153879836,154349090,6_108,48587,108,153928423
6,154377943,154891295,6_109,31706,109,154409649
6,154891670,155278160,6_110,63075,110,154954745
6,155352644,155668130,6_111,59551,111,155412195
6,155737419,156037773,6_112,32685,112,155770104
6,156052734,156285107,6_113,16530,113,156069264
6,156370182,156593980,6_114,38842,114,156409024
6,156594202,156831930,6_115,18287,115,156612489
6,156841620,157046029,6_116,16194,116,156857814
6,157120597,157281558,6_117,3121,117,157123718
6,157323797,157511503,6_118,15910,118,157339707
6,157550947,157775961,6_119,29155,119,157580102
6,157815510,158027438,6_120,35223,120,157850733
6,158084821,158295430,6_121,78039,121,158162860
6,158366366,158593218,6_122,38673,122,158405039
6,158622353,158759728,6_123,8654,123,158631007
6,159006009,159262585,6_124,30767,124,159036776
6,159335265,159680660,6_125,38135,125,159373400
6,159681132,160052635,6_126,73820,126,159754952
6,160120200,160350811,6_127,16650,127,160136850
6,160409555,160684432,6_128,37651,128,160447206
6,160700885,160887573,6_129,34105,129,160734990
6,161010247,161174867,6_130,22826,130,161033073
6,161213367,161365864,6_131,18713,131,161232080
6,161409939,161557517,6_132,29614,132,161439553
6,161564210,161722753,6_133,20354,133,161584564
6,161722891,161870002,6_134,19071,134,161741962
6,161889338,162021938,6_135,33528,135,161922866
6,162022224,162158189,6_136,27362,136,162049586
6,162161721,162290008,6_137,5004,137,162166725
6,162306533,162386790,6_138,13283,138,162319816
6,162443667,162532668,6_139,11220,139,162454887
6,162542366,162647370,6_140,27941,140,162570307
6,162662750,162772540,6_141,16506,141,162679256
6,162772551,162886571,6_142,4012,142,162776563
6,162913551,162992986,6_143,29925,143,162943476
6,162999115,163107200,6_144,18559,144,163017674
6,163107529,163214699,6_145,11375,145,163118904
6,163217515,163229147,6_146,6374,146,163223889
6,163337654,163429800,6_147,7598,147,163345252
6,163430195,163510526,6_148,12215,148,163442410
6,163621841,163633661,6_149,3414,149,163625255
6,163662280,163699338,6_150,1951,150,163664231
6,163766816,163860437,6_151,25187,151,163792003
6,163868421,163948970,6_152,8161,152,163876582
6,163973895,163989900,6_153,4580,153,163978475
6,164137157,164197730,6_154,18080,154,164155237
6,164205109,164309458,6_155,5152,155,164210261
6,164316603,164387029,6_156,13759,156,164330362
6,164471161,164552361,6_157,19768,157,164490929
6,164565070,164678708,6_158,16395,158,164581465
6,164679050,164805435,6_159,19718,159,164698768
6,164807430,164901821,6_160,15984,160,164823414
6,164984428,165080846,6_161,19133,161,165003561
6,165085294,165209145,6_162,39359,162,165124653
6,165238797,165359769,6_163,26457,163,165265254
6,165392037,165556653,6_164,16387,164,165408424
6,165560620,165706663,6_165,11233,165,165571853
6,165774252,165920053,6_166,8856,166,165783108
6,165939324,166096321,6_167,21640,167,165960964
6,166165510,166397712,6_168,23110,168,166188620
6,166463351,166671878,6_169,25719,169,166489070
6,166736091,167029928,6_170,39211,170,166775302
6,167031064,167436891,6_171,18809,171,167049873
6,167437828,167928301,6_172,46741,172,167484569
6,167938351,168442902,6_173,63444,173,168001795
6,168593447,168975400,6_174,18735,174,168612182
7,9822,32676,7_-8,4732,-8,14554
7,45197,119166,7_-7,2706,-7,47903
7,178440,185452,7_-6,1727,-6,180167
7,274413,274870,7_-5,317,-5,274730
7,305571,308256,7_-4,2693,-4,308264
7,428910,428910,7_-3,0,-3,428910
7,573447,578905,7_-1,942,-1,574389
7,641481,651165,7_0,0,0,641481
7,722938,773950,7_1,3311,1,726249
7,774194,806791,7_2,6316,2,780510
7,920913,923679,7_3,2085,3,922998
7,953015,997189,7_4,17617,4,970632
7,1063358,1069919,7_5,863,5,1064221
7,1120350,1148204,7_6,9714,6,1130064
7,1192192,1265739,7_7,9245,7,1201437
7,1266520,1317977,7_8,46978,8,1313498
7,1362331,1366523,7_9,3237,9,1365568
7,1441568,1441568,7_10,0,10,1441568
7,1516795,1569154,7_11,7266,11,1524061
7,1627446,1628892,7_12,870,12,1628316
7,1787574,1794597,7_14,4828,14,1792402
7,1853163,1932719,7_15,6134,15,1859297
7,1933488,1990562,7_16,18769,16,1952257
7,2041258,2076076,7_17,2760,17,2044018
7,2133042,2177828,7_18,13831,18,2146873
7,2207443,2207497,7_19,256,19,2207699
7,2292994,2360947,7_20,3278,20,2296272
7,2364050,2439795,7_21,1773,21,2365823
7,2462336,2537982,7_22,6163,22,2468499
7,2539543,2620057,7_23,22968,23,2562511
7,2629413,2712869,7_24,3934,24,2633347
7,2718116,2795588,7_25,14026,25,2732142
7,2874658,2891299,7_26,655,26,2875313
7,2902112,2981797,7_27,13017,27,2915129
7,2997211,3083115,7_28,7931,28,3005142
7,3162736,3178911,7_29,6160,29,3168896
7,3181792,3253105,7_30,6878,30,3188670
7,3338933,3365470,7_31,685,31,3339618
7,3483990,3574253,7_33,0,33,3483990
7,3588989,3672749,7_34,1775,34,3590764
7,3751687,3759551,7_35,0,35,3751687
7,3803780,3890912,7_36,2702,36,3806482
7,3892473,3904286,7_37,1217,37,3893690
7,4026930,4111770,7_38,10920,38,4037850
7,4112049,4162422,7_39,7392,39,4119441
7,4234044,4307266,7_40,7086,40,4241130
7,4373704,4373704,7_41,0,41,4373704
7,4465885,4582934,7_42,9339,42,4475224
7,4584273,4706719,7_43,3766,43,4588039
7,4707349,4829367,7_44,12102,44,4719451
7,4840791,4965778,7_45,14727,45,4855518
7,5037881,5103557,7_46,6970,46,5044851
7,5107497,5156493,7_47,21553,47,5129050
7,5262670,5356082,7_48,12452,48,5275122
7,5516565,5529639,7_49,12850,49,5529415
7,5551765,5658045,7_50,7057,50,5558822
7,5784659,5785039,7_51,0,51,5784659
7,5960362,5979361,7_52,2284,52,5962646
7,6064313,6146068,7_53,19807,53,6084120
7,6217198,6315961,7_54,13213,54,6230411
7,6356755,6445150,7_55,11362,55,6368117
7,6535176,6578227,7_56,8688,56,6543864
7,6725844,6855642,7_57,1733,57,6727577
7,6913170,7010781,7_58,5795,58,6918965
7,7059260,7171364,7_59,18305,59,7077565
7,7251446,7314480,7_60,25367,60,7276813
7,7410318,7574445,7_61,26994,61,7437312
7,7608344,7731749,7_62,922,62,7609266
7,7797624,7918669,7_63,9950,63,7807574
7,7954132,8098489,7_64,22713,64,7976845
7,8175535,8310027,7_65,25624,65,8201159
7,8313578,8472341,7_66,7062,66,8320640
7,8520327,8686948,7_67,9799,67,8530126
7,8687235,8876051,7_68,11285,68,8698520
7,8898687,9051536,7_69,5901,69,8904588
7,9098118,9270058,7_70,19828,70,9117946
7,9326758,9372531,7_71,9393,71,9336151
7,9527979,9711120,7_72,17435,72,9545414
7,9762692,9916684,7_73,20098,73,9782790
7,10009229,10177771,7_74,4183,74,10013412
7,10287147,10572475,7_75,18098,75,10305245
7,10572800,10972183,7_76,22259,76,10595059
7,11134147,11505985,7_77,20751,77,11154898
7,11570027,12545330,7_78,47949,78,11617976
7,12982784,14075057,7_79,46104,79,13028888
7,14080780,14705020,7_80,27665,80,14108445
7,14728300,15155740,7_81,12112,81,14740412
7,15211034,15606536,7_82,18220,82,15229254
7,15660392,16032957,7_83,1088,83,15661480
7,16096228,16345656,7_84,8857,84,16105085
7,16653441,17008446,7_85,13691,85,16667132
7,17141189,21919210,7_86,209538,86,17350727
7,17976110,22597174,7_87,209312,87,18185422
7,23234574,24369554,7_88,39257,88,23273831
7,24408228,28399218,7_89,99034,89,24507262
7,28454096,98124725,7_90,1340472,90,29794568
7,31907963,101266945,7_91,1342311,91,33250274
7,101574904,102759859,7_92,31598,92,101606502
7,103024459,104337568,7_93,27815,93,103052274
7,104399696,106232498,7_94,66727,94,104466423
7,106314593,113946528,7_95,211640,95,106526233
7,113962468,115821477,7_96,44186,96,114006654
7,115894526,121042761,7_97,231042,97,116125568
7,121178344,121844566,7_98,40340,98,121218684
7,121932942,122467409,7_99,22808,99,121955750
7,122535984,123028286,7_100,13174,100,122549158
7,123083663,123684275,7_101,27300,101,123110963
7,123692946,124539705,7_102,32422,102,123725368
7,124542402,126981313,7_103,104407,103,124646809
7,127094140,128140627,7_104,66412,104,127160552
7,128372627,128871137,7_105,31719,105,128404346
7,128895061,129367532,7_106,23483,106,128918544
7,129436583,129867394,7_107,18733,107,129455316
7,129868064,130267117,7_108,46930,108,129914994
7,130317643,130615641,7_109,11905,109,130329548
7,130642326,130951044,7_110,25163,110,130667489
7,130985174,131274669,7_111,25458,111,131010632
7,131278359,131446171,7_112,18733,112,131297092
7,131642808,131841288,7_113,20581,113,131663389
7,131882822,132107803,7_114,13527,114,131896349
7,132157575,132393365,7_115,13115,115,132170690
7,132442931,132640159,7_116,7296,116,132450227
7,132686815,132915106,7_117,11006,117,132697821
7,133030154,133179515,7_118,18942,118,133049096
7,133243133,133463036,7_119,20461,119,133263594
7,133530126,133652652,7_120,24334,120,133554460
7,133802518,134105389,7_121,29397,121,133831915
7,134124614,134314743,7_122,19126,122,134143740
7,134703362,138891639,7_123,191655,123,134895017
7,134970995,139725295,7_124,240870,124,135211865
7,135960764,140258920,7_125,239813,125,136200577
7,140327125,140689569,7_126,37664,126,140364789
7,140689652,141011166,7_127,24659,127,140714311
7,141104551,141328692,7_128,7380,128,141111931
7,141396632,141719379,7_129,42131,129,141438763
7,141729310,142032234,7_130,33771,130,141763081
7,142107167,142394604,7_131,24360,131,142131527
7,142396867,142686573,7_132,13623,132,142410490
7,142774653,143127499,7_133,30720,133,142805373
7,143207722,143527893,7_134,37934,134,143245656
7,143630896,144028851,7_135,21992,135,143652888
7,144087246,144663403,7_136,47622,136,144134868
7,144683662,150031721,7_137,370396,137,145054058
7,145621721,152448050,7_138,496720,138,146118441
7,152448268,153254704,7_139,86357,139,152534625
7,153283207,153857676,7_140,70447,140,153353654
7,153993628,154297826,7_141,27638,141,154021266
7,154357376,154752004,7_142,35743,142,154393119
7,154783167,155112726,7_143,24323,143,154807490
7,155147175,155392736,7_144,27775,144,155174950
7,155560706,155812709,7_145,32471,145,155593177
7,155836344,156123823,7_146,15999,146,155852343
7,156184317,156288897,7_147,15595,147,156199912
7,156473251,156717614,7_148,29517,148,156502768
7,156726289,156928305,7_149,18996,149,156745285
7,157011779,157270251,7_150,17870,150,157029649
7,157276334,157504765,7_151,22483,151,157298817
7,157569497,157758939,7_152,39181,152,157608678
7,157836678,157955081,7_153,13585,153,157850263
7,158030245,158244396,7_154,30967,154,158061212
7,158261351,158467617,7_155,11540,155,158272891
7,158592716,158592716,7_156,0,156,158592716
7,158748669,158853534,7_157,0,157,158748669
7,158927612,159049927,7_158,45052,158,158972664
7,159131671,159237549,7_159,1419,159,159133090
7,159365611,159432827,7_160,4672,160,159370283
7,159461877,159604693,7_161,26541,161,159488418
7,159727105,159784441,7_162,16773,162,159743878
7,159847225,159921792,7_163,19225,163,159866450
7,160016736,160139303,7_164,24621,164,160041357
7,160142894,160292776,7_165,26733,165,160169627
7,160311922,160455604,7_166,5705,166,160317627
7,160480385,160625919,7_167,13887,167,160494272
7,160681930,160780861,7_168,958,168,160682888
7,160810285,160947979,7_169,2043,169,160812328
7,160983444,161129958,7_170,8917,170,160992361
7,161263039,161290183,7_171,7360,171,161270399
7,161337162,161445362,7_172,17082,172,161354244
7,161609491,161620472,7_173,4210,173,161613701
7,161657684,161835124,7_174,17337,174,161675021
7,161840880,162024656,7_175,11755,175,161852635
7,162025064,162210367,7_176,28369,176,162053433
7,162256652,162431132,7_177,26409,177,162283061
7,162535226,162566399,7_178,5383,178,162540609
7,162666411,162859916,7_179,30939,179,162697350
7,162949251,163123485,7_180,37791,180,162987042
7,163209792,163377567,7_181,12871,181,163222663
7,163512547,163690855,7_182,30451,182,163542998
7,163778997,163989287,7_183,19440,183,163798437
7,164070254,164242902,7_184,22081,184,164092335
7,164412155,164567310,7_185,6005,185,164418160
7,164599559,164834238,7_186,25820,186,164625379
7,164948211,165035335,7_187,23604,187,164971815
7,165097032,165256654,7_188,20226,188,165117258
7,165295201,165474693,7_189,24903,189,165320104
7,165481665,165585900,7_190,15455,190,165497120
7,165666763,165820070,7_191,19447,191,165686210
7,165835537,165990923,7_192,17661,192,165853198
7,166109475,166132691,7_193,3401,193,166112876
7,166159054,166193836,7_194,7791,194,166166845
7,166349637,166387870,7_195,9869,195,166359506
7,166463815,166600790,7_196,14515,196,166478330
7,166665764,166753995,7_197,17043,197,166682807
7,166756058,166858184,7_198,4403,198,166760461
7,166956780,167030806,7_199,5259,199,166962039
7,167042668,167155360,7_200,26261,200,167068929
7,167217520,167241605,7_201,10629,201,167228149
7,167333542,167348830,7_202,7321,202,167340863
7,167485381,167610337,7_203,20488,203,167505869
7,167620279,167729721,7_204,9633,204,167629912
7,167807720,167915762,7_205,30083,205,167837803
7,167935766,168090829,7_206,22166,206,167957932
7,168103584,168255498,7_207,14511,207,168118095
7,168275070,168409634,7_208,13704,208,168288774
7,168454968,168659514,7_209,28206,209,168483174
7,168660113,168866732,7_210,25202,210,168685315
7,168901353,169178105,7_211,17798,211,168919151
7,169202559,169576762,7_212,51682,212,169254241
7,169587141,170148464,7_213,27999,213,169615140
7,170245135,171016663,7_214,147214,214,170392349
7,171035544,171862723,7_215,100259,215,171135803
7,171924795,172718743,7_216,115763,216,172040558
7,172722059,173555057,7_217,129649,217,172851708
7,173597897,174404712,7_218,88641,218,173686538
7,174442670,175210259,7_219,118106,219,174560776
7,175278194,176025566,7_220,93457,220,175371651
7,176127649,176719929,7_221,33018,221,176160667
8,97087,98540,8_-3,2948,-3,100035
8,165381,333487,8_-2,5650,-2,171031
8,355231,562879,8_-1,15008,-1,370239
8,615430,775219,8_0,17798,0,633228
8,814140,968986,8_1,14386,1,828526
8,1091749,1221600,8_2,4571,2,1096320
8,1342896,1455355,8_3,16955,3,1359851
8,1514495,1649250,8_4,10757,4,1525252
8,1743547,1900987,8_5,12261,5,1755808
8,1905373,2115498,8_6,21114,6,1926487
8,2153671,2319554,8_7,5954,7,2159625
8,2349858,2522619,8_8,13902,8,2363760
8,2555342,2678540,8_9,0,9,2555342
8,2760881,2960783,8_10,3081,10,2763962
8,2991572,3167736,8_11,13242,11,3004814
8,3195460,3350158,8_12,21290,12,3216750
8,3394567,3576432,8_13,10207,13,3404774
8,3629230,3795208,8_14,6216,14,3635446
8,3795313,3982798,8_15,17258,15,3812571
8,4059536,4176562,8_16,6747,16,4066283
8,4232553,4430434,8_17,12646,17,4245199
8,4430841,4624526,8_18,23366,18,4454207
8,4786737,4868238,8_19,13903,19,4800640
8,4879088,5035703,8_20,21924,20,4901012
8,5135455,5334204,8_21,12387,21,5147842
8,5363105,5609584,8_22,15620,22,5378725
8,5645045,5854447,8_23,8854,23,5653899
8,5886240,6150905,8_24,20226,24,5906466
8,6281364,6467906,8_25,8847,25,6290211
8,6481868,6812325,8_26,28234,26,6510102
8,6818526,7108758,8_27,21038,27,6839564
8,7279702,7522444,8_28,14817,28,7294519
8,7617182,8018274,8_29,32248,29,7649430
8,8022478,8474740,8_30,48855,30,8071333
8,8557406,8928656,8_31,19723,31,8577129
8,8976801,9436670,8_32,18491,32,8995292
8,9439625,9876631,8_33,16464,33,9456089
8,9901314,10294570,8_34,46566,34,9947880
8,10294781,10661885,8_35,13632,35,10308413
8,10756025,10944627,8_36,27020,36,10783045
8,11249635,11342723,8_37,2973,37,11252608
8,11388424,11681969,8_38,29328,38,11417752
8,11771242,12052614,8_39,4175,39,11775417
8,12092958,12359396,8_40,12902,40,12105860
8,12555754,12684448,8_41,7956,41,12563710
8,12768669,13044809,8_42,37722,42,12806391
8,13137245,13444744,8_43,42378,43,13179623
8,13551575,13804247,8_44,21854,44,13573429
8,13911106,14240500,8_45,44229,45,13955335
8,14276355,14666735,8_46,21606,46,14297961
8,14700920,15110832,8_47,38834,47,14739754
8,15242811,15604005,8_48,20530,48,15263341
8,15798325,16076575,8_49,16118,49,15814443
8,16164312,16641004,8_50,18794,50,16183106
8,16690914,17071812,8_51,40737,51,16731651
8,17175414,17572358,8_52,25078,52,17200492
8,17662721,17971135,8_53,15310,53,17678031
8,18202618,18451190,8_54,34411,54,18237029
8,18605671,18823499,8_55,9643,55,18615314
8,18870846,19250250,8_56,11614,56,18882460
8,19379085,19613240,8_57,16560,57,19395645
8,19659848,19977098,8_58,12186,58,19672034
8,20031700,20309997,8_59,12882,59,20044582
8,20488546,20692742,8_60,13107,60,20501653
8,20695747,20976807,8_61,26994,61,20722741
8,21060590,21303090,8_62,31836,62,21092426
8,21386173,21700966,8_63,10944,63,21397117
8,21753436,22054724,8_64,29607,64,21783043
8,22084510,22397409,8_65,8486,65,22092996
8,22436537,22686377,8_66,15284,66,22451821
8,22815162,23115710,8_67,12548,67,22827710
8,23155915,23498906,8_68,21530,68,23177445
8,23636338,23889819,8_69,14377,69,23650715
8,23954163,24355267,8_70,14523,70,23968686
8,24411987,24869211,8_71,22460,71,24434447
8,24926353,25391637,8_72,27132,72,24953485
8,25474087,26092058,8_73,15714,73,25489801
8,26095163,26922685,8_74,30344,74,26125507
8,27117204,59170403,8_75,603735,75,27720939
8,28589925,62668963,8_76,595639,76,29185564
8,62827000,65101145,8_77,92683,77,62919683
8,65178554,67737816,8_78,102180,78,65280734
8,67848742,70387734,8_79,105407,79,67954149
8,70402311,72424529,8_80,78462,80,70480773
8,72616464,74456671,8_81,71358,81,72687822
8,74521998,76529045,8_82,86160,82,74608158
8,76643729,80505269,8_83,160027,83,76803756
8,80620753,91023332,8_84,256181,84,80876934
8,91058777,93801781,8_85,64290,85,91123067
8,93920355,96446381,8_86,94206,86,94014561
8,96629405,98599220,8_87,74700,87,96704105
8,98655115,100202038,8_88,34947,88,98690062
8,100393943,116625708,8_89,634265,89,101028208
8,101508050,117201238,8_90,600297,90,102108347
8,102619725,117644803,8_91,566803,91,103186528
8,103899976,118011441,8_92,556240,92,104456216
8,105086915,118325331,8_93,536293,93,105623208
8,107389201,118593139,8_94,458153,94,107847354
8,118652600,118912818,8_95,34865,95,118687465
8,118969272,119229042,8_96,15575,96,118984847
8,119236172,119494770,8_97,13563,97,119249735
8,119579763,119908229,8_98,27331,98,119607094
8,119934625,120255380,8_99,27599,99,119962224
8,120456975,120757085,8_100,10585,100,120467560
8,120875548,121437452,8_101,15407,101,120890955
8,121485615,122151528,8_102,27134,102,121512749
8,122221328,122906711,8_103,45997,103,122267325
8,122924720,123538569,8_104,40969,104,122965689
8,123602769,124222014,8_105,30736,105,123633505
8,124224243,124849288,8_106,43442,106,124267685
8,124930039,125621090,8_107,50874,107,124980913
8,125741588,128117990,8_108,99063,108,125840651
8,128124235,131639940,8_109,193677,109,128317912
8,131672961,133200899,8_110,98622,110,131771583
8,133259801,153268615,8_111,1266320,111,134526121
8,135085789,154749078,8_112,1205065,112,136290854
8,136580616,155667127,8_113,1198327,113,137778943
8,155810532,156441465,8_114,64540,114,155875072
8,156460391,157004943,8_115,73693,115,156534084
8,157086113,157621670,8_116,72239,116,157158352
8,157638764,158118615,8_117,43997,117,157682761
8,158119141,158571975,8_118,19187,118,158138328
8,158572226,158980935,8_119,13684,119,158585910
8,158982856,159335164,8_120,47809,120,159030665
8,159373281,159710775,8_121,39106,121,159412387
8,159789406,160007549,8_122,38068,122,159827474
8,160080867,160388589,8_123,37014,123,160117881
8,160388776,160610375,8_124,26621,124,160415397
8,160699695,160982936,8_125,23278,125,160722973
8,161042590,161217475,8_126,19814,126,161062404
8,161389645,161525087,8_127,15574,127,161405219
8,161526497,161779701,8_128,27193,128,161553690
8,161781049,161938245,8_129,16351,129,161797400
8,162043834,162238524,8_130,26455,130,162070289
8,162332897,162467410,8_131,2889,131,162335786
8,162507123,162666251,8_132,18814,132,162525937
8,162721826,162859977,8_133,19328,133,162741154
8,162965158,163039801,8_134,7010,134,162972168
8,163121384,163293262,8_135,24541,135,163145925
8,163307720,163477139,8_136,26053,136,163333773
8,163509298,163674500,8_137,23932,137,163533230
8,163678400,163848371,8_138,17828,138,163696228
8,163890937,164042596,8_139,14120,139,163905057
8,164059234,164206015,8_140,31465,140,164090699
8,164356614,164391152,8_141,10142,141,164366756
8,164429758,164578477,8_142,14999,142,164444757
8,164614836,164768115,8_143,29792,143,164644628
8,164771564,164939863,8_144,25200,144,164796764
8,164957847,165041857,8_145,1068,145,164958915
8,165142482,165293145,8_146,40755,146,165183237
8,165349139,165447889,8_147,9161,147,165358300
8,165530145,165656010,8_148,22011,148,165552156
8,165678789,165827062,8_149,11611,149,165690400
8,165854008,165999298,8_150,13294,150,165867302
8,166078713,166195590,8_151,9400,151,166088113
8,166227768,166405124,8_152,8191,152,166235959
8,166407582,166581849,8_153,17220,153,166424802
8,166613505,166780491,8_154,14617,154,166628122
8,166780688,166967068,8_155,38899,155,166819587
8,166971079,167156480,8_156,15351,156,166986430
8,167158082,167305066,8_157,18036,157,167176118
8,167381092,167478415,8_158,9995,158,167391087
8,167558100,167713509,8_159,3369,159,167561469
8,167756162,167889182,8_160,18022,160,167774184
8,167982620,168076948,8_161,21160,161,168003780
8,168117075,168280210,8_162,29055,162,168146130
8,168280859,168431246,8_163,11836,163,168292695
8,168479182,168564370,8_164,3542,164,168482724
8,168648000,168816988,8_165,10007,165,168658007
8,168824072,168958738,8_166,10411,166,168834483
8,169009761,169162128,8_167,18209,167,169027970
8,169184918,169322336,8_168,12718,168,169197636
8,169400386,169499144,8_169,8612,169,169408998
8,169502232,169664263,8_170,27553,170,169529785
8,169664707,169792706,8_171,14762,171,169679469
8,169859732,169980560,8_172,13257,172,169872989
8,169983273,170135674,8_173,21759,173,170005032
8,170136052,170287219,8_174,14158,174,170150210
8,170291269,170415047,8_175,21230,175,170312499
8,170445481,170460326,8_176,2110,176,170447591
8,170605329,170709637,8_177,12650,177,170617979
8,170738343,170867059,8_178,32066,178,170770409
8,170878216,171012820,8_179,9220,179,170887436
8,171014127,171150681,8_180,10449,180,171024576
8,171169532,171277738,8_181,18950,181,171188482
8,171293974,171413691,8_182,25537,182,171319511
8,171439330,171551477,8_183,14363,183,171453693
8,171559883,171681002,8_184,28674,184,171588557
8,171704607,171815622,8_185,28494,185,171733101
8,171852366,171943084,8_186,18194,186,171870560
8,171957262,172033092,8_187,12485,187,171969747
8,172115697,172198592,8_188,10003,188,172125700
8,172204716,172261337,8_189,21748,189,172226464
8,172345541,172412650,8_190,11719,190,172357260
8,172455220,172568383,8_191,13369,191,172468589
8,172594760,172692977,8_192,6069,192,172600829
8,172695742,172812391,8_193,15206,193,172710948
8,172869756,172903440,8_194,4532,194,172874288
8,172948177,173044184,8_195,22819,195,172970996
8,173057507,173120368,8_196,39212,196,173096719
8,173177801,173252081,8_197,11393,197,173189194
8,173307395,173394122,8_198,11276,198,173318671
8,173405501,173515554,8_199,22067,199,173427568
8,173548136,173621050,8_200,12100,200,173560236
8,173639568,173720698,8_201,11622,201,173651190
8,173788617,173856838,8_202,13156,202,173801773
8,173864165,173974336,8_203,7863,203,173872028
8,173975241,174065168,8_204,4128,204,173979369
8,174092021,174186238,8_205,12024,205,174104045
8,174211928,174312766,8_206,22204,206,174234132
8,174315069,174424177,8_207,22906,207,174337975
8,174426175,174538645,8_208,12584,208,174438759
8,174538868,174619858,8_209,5915,209,174544783
8,174678885,174761682,8_210,2614,210,174681499
8,174769299,174788717,8_211,3637,211,174772936
8,174892662,174983604,8_212,5248,212,174897910
8,175060154,175093730,8_213,12934,213,175073088
8,175151011,175188588,8_214,3352,214,175154363
8,175215813,175295492,8_215,5725,215,175221538
8,175321778,175403074,8_216,3310,216,175325088
8,175459153,175509350,8_217,2663,217,175461816
8,175555738,175628459,8_218,2342,218,175558080
8,175697801,175733215,8_219,7046,219,175704847
8,175773141,175787674,8_220,0,220,175773141
9,311732,318726,9_-3,2128,-3,313860
9,464742,580427,9_-2,4852,-2,469594
9,700361,706448,9_-1,1133,-1,701494
9,958546,1114318,9_0,7140,0,965686
9,1146313,1377509,9_1,11829,1,1158142
9,1428586,1637364,9_2,8262,2,1436848
9,1638606,1893678,9_3,12148,3,1650754
9,1909007,2146008,9_4,10054,4,1919061
9,2155376,2403083,9_5,11244,5,2166620
9,2442776,2635173,9_6,9137,6,2451913
9,2711832,2834679,9_7,3925,7,2715757
9,2952736,3138392,9_8,10228,8,2962964
9,3243328,3452204,9_9,7905,9,3251233
9,3459510,3704146,9_10,3795,10,3463305
9,3743654,3936972,9_11,8818,11,3752472
9,4009514,4225279,9_12,815,12,4010329
9,4283890,4532456,9_13,17052,13,4300942
9,4534633,4777312,9_14,4650,14,4539283
9,4833298,5084496,9_15,13466,15,4846764
9,5123759,5358436,9_16,9926,16,5133685
9,5411307,5656580,9_17,6412,17,5417719
9,5859834,5878321,9_18,1049,18,5860883
9,5990541,6225579,9_19,13868,19,6004409
9,6256828,6498644,9_20,12723,20,6269551
9,6572517,6839621,9_21,8222,21,6580739
9,6887295,7180232,9_22,18614,22,6905909
9,7181216,7444564,9_23,19523,23,7200739
9,7575007,7772425,9_24,22324,24,7597331
9,7869597,8136947,9_25,14786,25,7884383
9,8172496,8470998,9_26,17774,26,8190270
9,8520504,8806841,9_27,11801,27,8532305
9,8809353,9129158,9_28,8238,28,8817591
9,9220647,9445928,9_29,10303,29,9230950
9,9464969,9741722,9_30,26257,30,9491226
9,9813442,10057767,9_31,12506,31,9825948
9,10087350,10367119,9_32,9401,32,10096751
9,10387658,10596431,9_33,2589,33,10390247
9,10771804,10905737,9_34,11893,34,10783697
9,10941935,11165978,9_35,34941,35,10976876
9,11217183,11456779,9_36,21616,36,11238799
9,11458306,11629699,9_37,35917,37,11494223
9,11703181,11929551,9_38,28489,38,11731670
9,11970868,12110245,9_39,14059,39,11984927
9,12246523,12379979,9_40,24557,40,12271080
9,12426190,12619438,9_41,12994,41,12439184
9,12619779,12829723,9_42,14237,42,12634016
9,12861281,12993823,9_43,10335,43,12871616
9,13148972,13176365,9_44,7744,44,13156716
9,13353013,13463103,9_45,9201,45,13362214
9,13485932,13666388,9_46,5174,46,13491106
9,13704565,13915728,9_47,30263,47,13734828
9,13915877,14115111,9_48,7316,48,13923193
9,14154807,14327784,9_49,9691,49,14164498
9,14457465,14554586,9_50,14034,50,14471499
9,14618658,14831656,9_51,6265,51,14624923
9,14833155,15086294,9_52,19309,52,14852464
9,15086513,15314684,9_53,8497,53,15095010
9,15357370,15618072,9_54,27986,54,15385356
9,15692185,15916982,9_55,6160,55,15698345
9,15974611,16286882,9_56,33995,56,16008606
9,16317720,16684173,9_57,30362,57,16348082
9,16717711,17101612,9_58,27721,58,16745432
9,17230948,17860208,9_59,51795,59,17282743
9,17892239,18683890,9_60,34544,60,17926783
9,18724253,19613713,9_61,128574,61,18852827
9,19657495,20478017,9_62,70290,62,19727785
9,20583447,21313679,9_63,43626,63,20627073
9,21424122,22160383,9_64,35476,64,21459598
9,22326968,22948672,9_65,25394,65,22352362
9,23009333,23815866,9_66,54876,66,23064209
9,24050190,24598983,9_67,70320,67,24120510
9,24698777,25274137,9_68,55569,68,24754346
9,25354089,25927145,9_69,63184,69,25417273
9,25978801,26486213,9_70,24112,70,26002913
9,26550042,27015440,9_71,75429,71,26625471
9,27018040,27441615,9_72,34897,72,27052937
9,27833647,28039908,9_73,15047,73,27848694
9,28046153,28619594,9_74,41048,74,28087201
9,28821226,51413464,9_75,504145,75,29325371
9,30049797,83693974,9_76,1087502,76,31137299
9,83787779,88108825,9_77,135401,77,83923180
9,88159861,90184763,9_78,74647,78,88234508
9,90189473,96446821,9_79,238735,79,90428208
9,96576217,97428214,9_80,38284,80,96614501
9,97537373,98488455,9_81,12807,81,97550180
9,98491983,101203429,9_82,121362,82,98613345
9,101259781,103355316,9_83,104762,83,101364543
9,103528761,104589931,9_84,34805,84,103563566
9,104624647,105694093,9_85,57512,85,104682159
9,105977353,108102616,9_86,64239,86,106041592
9,108203115,110718954,9_87,109346,87,108312461
9,110839480,112017059,9_88,45050,88,110884530
9,112104167,112953177,9_89,43989,89,112148156
9,113016955,113820857,9_90,58121,90,113075076
9,113823273,114699243,9_91,58583,91,113881856
9,114708222,115958873,9_92,55021,92,114763243
9,116047882,119973528,9_93,159871,93,116207753
9,120079698,122039468,9_94,97317,94,120177015
9,122054809,125254688,9_95,190771,95,122245580
9,125297879,126340988,9_96,69954,96,125367833
9,126408614,127013845,9_97,42934,97,126451548
9,127186654,127876197,9_98,69457,98,127256111
9,127924466,128644570,9_99,54644,99,127979110
9,128649144,129519829,9_100,100079,100,128749223
9,129715993,132551957,9_101,154642,101,129870635
9,132690192,134118550,9_102,65691,102,132755883
9,134151157,134879428,9_103,56593,103,134207750
9,134917179,135470635,9_104,40198,104,134957377
9,135480565,135900866,9_105,13302,105,135493867
9,136004285,136303521,9_106,17241,106,136021526
9,136378761,136712355,9_107,27130,107,136405891
9,136769885,137085463,9_108,36250,108,136806135
9,137088765,137368211,9_109,25856,109,137114621
9,137411204,137652183,9_110,9909,110,137421113
9,137734095,137994915,9_111,30757,111,137764852
9,138020950,138306580,9_112,25556,112,138046506
9,138307831,138558417,9_113,39538,113,138347369
9,138608119,138801891,9_114,49312,114,138657431
9,138876768,139148496,9_115,25770,115,138902538
9,139161217,139424857,9_116,29928,116,139191145
9,139493307,139707105,9_117,35669,117,139528976
9,139707312,139987853,9_118,19471,118,139726783
9,140013280,140221117,9_119,20595,119,140033875
9,140337762,140522644,9_120,32146,120,140369908
9,140587833,140783206,9_121,7001,121,140594834
9,140823542,141086655,9_122,27885,122,140851427
9,141097151,141334097,9_123,15898,123,141113049
9,141368904,141548491,9_124,18633,124,141387537
9,141709648,141851712,9_125,9359,125,141719007
9,141928000,142054186,9_126,23928,126,141951928
9,142156866,142304225,9_127,32331,127,142189197
9,142331474,142497923,9_128,27425,128,142358899
9,142619411,142664393,9_129,8779,129,142628190
9,142736124,142930314,9_130,14824,130,142750948
9,142931990,143053638,9_131,16213,131,142948203
9,143153294,143235242,9_132,36270,132,143189564
9,143338533,143397039,9_133,6046,133,143344579
9,143539188,143663032,9_134,10201,134,143549389
9,143795593,143808142,9_135,7890,135,143803483
9,143841722,144002941,9_136,15097,136,143856819
9,144034599,144171296,9_137,8269,137,144042868
9,144298435,144339420,9_138,9850,138,144308285
9,144374103,144512449,9_139,10328,139,144384431
9,144518628,144638978,9_140,20440,140,144539068
9,144762882,144826359,9_141,9922,141,144772804
9,144878621,145037697,9_142,6995,142,144885616
9,145038072,145179192,9_143,17211,143,145055283
9,145281730,145384682,9_144,17916,144,145299646
9,145500699,145531213,9_145,11599,145,145512298
9,145587935,145778070,9_146,18286,146,145606221
9,145843763,145930896,9_147,7681,147,145851444
9,146013034,146155017,9_148,24307,148,146037341
9,146205080,146410518,9_149,13969,149,146219049
9,146410708,146538641,9_150,26322,150,146437030
9,146665334,146890814,9_151,17313,151,146682647
9,146897367,147152354,9_152,31035,152,146928402
9,147152550,147412249,9_153,57368,153,147209918
9,147420490,147690798,9_154,59339,154,147479829
9,147691600,147897351,9_155,20874,155,147712474
9,147959063,148222099,9_156,45553,156,148004616
9,148225367,148448286,9_157,13547,157,148238914
9,148488741,148675822,9_158,8661,158,148497402
9,148774914,148920242,9_159,4553,159,148779467
9,149006262,149126742,9_160,22718,160,149028980
9,149163899,149304614,9_161,23307,161,149187206
9,149364642,149537738,9_162,25127,162,149389769
9,149537774,149684403,9_163,13227,163,149551001
9,149724600,149828245,9_164,16232,164,149740832
9,149894370,149990641,9_165,8428,165,149902798
9,150092235,150207725,9_166,3786,166,150096021
9,150216105,150354987,9_167,15351,167,150231456
9,150419205,150495789,9_168,9310,168,150428515
9,150604726,150651365,9_169,2743,169,150607469
9,150652820,150768857,9_170,22969,170,150675789
9,150797514,150923587,9_171,18589,171,150816103
9,150962640,151052765,9_172,2734,172,150965374
9,151069796,151185012,9_173,6760,173,151076556
9,151248198,151329438,9_174,64526,174,151312724
9,151361982,151430588,9_175,18224,175,151380206
9,151461213,151576438,9_176,32432,176,151493645
9,151630965,151712094,9_177,28058,177,151659023
9,151720217,151823425,9_178,22353,178,151742570
9,151969593,151970281,9_179,0,179,151969593
9,151970632,152092796,9_180,28567,180,151999199
9,152134203,152208498,9_181,10475,181,152144678
9,152242344,152314656,9_182,12347,182,152254691
9,152367093,152462406,9_183,7228,183,152374321
9,152480627,152556880,9_184,7535,184,152488162
9,152633995,152708611,9_185,12573,185,152646568
9,152747581,152865619,9_186,30654,186,152778235
9,152886437,152937162,9_187,3531,187,152889968
9,153034566,153038151,9_188,3687,188,153038253
9,153158489,153221366,9_189,13247,189,153171736
9,153265405,153335800,9_190,26267,190,153291672
9,153412887,153541993,9_191,30416,191,153443303
9,153542865,153674554,9_192,18431,192,153561296
9,153687363,153831562,9_193,17807,193,153705170
9,153831665,153977991,9_194,23459,194,153855124
9,154015491,154099625,9_195,19086,195,154034577
9,154236436,154248970,9_196,7013,196,154243449
9,154301476,154439758,9_197,63201,197,154364677
9,154454376,154607872,9_198,39633,198,154494009
9,154608683,154768828,9_199,26786,199,154635469
9,154769344,154935496,9_200,10745,200,154780089
9,154945396,155099941,9_201,22260,201,154967656
9,155101910,155214536,9_202,5106,202,155107016
9,155277419,155376168,9_203,11408,203,155288827
9,155437822,155596925,9_204,21760,204,155459582
9,155683156,155765995,9_205,16486,205,155699642
9,155791746,155864125,9_206,3545,206,155795291
9,155976018,155976018,9_207,0,207,155976018
9,156201726,156211360,9_208,1697,208,156203423
9,156417293,156417293,9_209,0,209,156417293
10,626964,814280,10_3,5622,3,632586
10,1025243,1350298,10_4,46205,4,1071448
10,1416792,1722601,10_5,25836,5,1442628
10,1722882,2054547,10_6,61287,6,1784169
10,2113848,2260956,10_7,21124,7,2134972
10,2403775,2482017,10_8,18590,8,2422365
10,2627146,2801261,10_9,28786,9,2655932
10,2836996,3025035,10_10,11583,10,2848579
10,3061542,3209244,10_11,26263,11,3087805
10,3258229,3400739,10_12,25636,12,3283865
10,3438769,3570225,10_13,11239,13,3450008
10,3644226,3714968,10_14,10441,14,3654667
10,3757292,3868823,10_15,11198,15,3768490
10,3908304,4019609,10_16,16769,16,3925073
10,4021152,4099388,10_17,13443,17,4034595
10,4166220,4266509,10_18,4038,18,4170258
10,4308386,4411070,10_19,6791,19,4315177
10,4446994,4528007,10_20,9201,20,4456195
10,4558372,4674098,10_21,37989,21,4596361
10,4674857,4777187,10_22,16539,22,4691396
10,4818974,4910531,10_23,11274,23,4830248
10,4984244,5006869,10_24,9590,24,4993834
10,5107657,5123965,10_25,5918,25,5113575
10,5217429,5280139,10_26,1849,26,5219278
10,5375704,5404051,10_27,6390,27,5382094
10,5440110,5533265,10_28,13495,28,5453605
10,5582210,5647515,10_29,19375,29,5601585
10,5719061,5804189,10_30,13155,30,5732216
10,5868913,6009875,10_31,14613,31,5883526
10,6067455,6165417,10_32,3584,32,6071039
10,6201059,6356072,10_33,5149,33,6206208
10,6372837,6547496,10_34,6533,34,6379370
10,6590123,6749079,10_35,9678,35,6599801
10,6854641,7105506,10_36,13798,36,6868439
10,7106240,7440520,10_37,29941,37,7136181
10,7466123,7924339,10_38,17471,38,7483594
10,7964105,8660782,10_39,18215,39,7982320
10,8702185,9599385,10_40,65838,40,8768023
10,9781478,10475072,10_41,46334,41,9827812
10,10541287,11196293,10_42,46058,42,10587345
10,11314488,12189618,10_43,35718,43,11350206
10,12350390,13376351,10_44,41641,44,12392031
10,13470110,14520034,10_45,39421,45,13509531
10,14539473,15408207,10_46,31561,46,14571034
10,15547792,16176306,10_47,22125,47,15569917
10,16201845,16662436,10_48,25277,48,16227122
10,16959892,17678602,10_49,23114,49,16983006
10,17886006,39496376,10_50,505059,50,18391065
10,23781223,55898929,10_51,517513,51,24298736
10,24951105,57315907,10_52,507456,52,25458561
10,41327831,58581639,10_53,195846,53,41523677
10,42443034,60169075,10_54,237963,54,42680997
10,43214265,66321108,10_55,370666,55,43584931
10,66544798,76420802,10_56,261933,56,66806731
10,76505654,77558577,10_57,47906,57,76553560
10,77574255,78379869,10_58,31207,58,77605462
10,78602702,79453385,10_59,19196,59,78621898
10,79753358,80719013,10_60,44637,60,79797995
10,80735476,83597391,10_61,111189,61,80846665
10,83641116,85952007,10_62,125443,62,83766559
10,86097049,98385807,10_63,473139,63,86570188
10,98637872,101287748,10_64,107727,64,98745599
10,101361676,105620395,10_65,124691,65,101486367
10,105683852,111318236,10_66,221443,66,105905295
10,111422888,113138535,10_67,57371,67,111480259
10,113162143,114362733,10_68,48523,68,113210666
10,114483966,119476466,10_69,227116,69,114711082
10,119552330,120949751,10_70,103136,70,119655466
10,121205574,122380869,10_71,70706,71,121276280
10,122436475,124191703,10_72,96329,72,122532804
10,124230730,125132732,10_73,72943,73,124303673
10,125195458,125724889,10_74,26837,74,125222295
10,125829434,126310146,10_75,54985,75,125884419
10,126490392,126930799,10_76,40043,76,126530435
10,126982144,130829455,10_77,309927,77,127292071
10,127808008,131801759,10_78,258874,78,128066882
10,131802076,132322710,10_79,68255,79,131870331
10,132343655,132796821,10_80,52132,80,132395787
10,132881904,133301480,10_81,43487,81,132925391
10,133301508,133824289,10_82,49539,82,133351047
10,133876386,134440659,10_83,51349,83,133927735
10,134456722,135177538,10_84,43522,84,134500244
10,135274332,135803762,10_85,39257,85,135313589
10,135911735,136299699,10_86,41924,86,135953659
10,136315553,136651133,10_87,9735,87,136325288
10,136693392,136965881,10_88,19559,88,136712951
10,137100057,137246790,10_89,14019,89,137114076
10,137266783,137507672,10_90,18803,90,137285586
10,137538391,137754388,10_91,27785,91,137566176
10,137772535,137995444,10_92,7188,92,137779723
10,138018457,138220033,10_93,22016,93,138040473
10,138261605,138499216,10_94,15781,94,138277386
10,138592946,138730899,10_95,15409,95,138608355
10,138772997,139054147,10_96,24235,96,138797232
10,139073882,139349810,10_97,21427,97,139095309
10,139393757,139510531,10_98,6625,98,139400382
10,139732293,140054319,10_99,33061,99,139765354
10,140081769,140357395,10_100,21664,100,140103433
10,140493813,140778643,10_101,20674,101,140514487
10,140843660,141130376,10_102,27327,102,140870987
10,141230561,141483414,10_103,43553,103,141274114
10,141500270,141710726,10_104,35346,104,141535616
10,141819653,142035559,10_105,30635,105,141850288
10,142036147,142254895,10_106,21614,106,142057761
10,142280022,142483006,10_107,46098,107,142326120
10,142506565,142678049,10_108,23581,108,142530146
10,142712362,142852666,10_109,30285,109,142742647
10,142908509,143083597,10_110,25124,110,142933633
10,143162995,143276378,10_111,34229,111,143197224
10,143378047,143455128,10_112,6769,112,143384816
10,143480887,143538864,10_113,21892,113,143502779
10,143662935,143826166,10_114,22812,114,143685747
10,143901630,143935566,10_115,1269,115,143902899
10,144032227,144190292,10_116,9726,116,144041953
10,144192989,144317734,10_117,10089,117,144203078
10,144422258,144530205,10_118,24511,118,144446769
10,144553933,144719589,10_119,31548,119,144585481
10,144724084,144855249,10_120,19739,120,144743823
10,144912832,145024420,10_121,18947,121,144931779
10,145094754,145207418,10_122,19145,122,145113899
10,145254849,145378986,10_123,8568,123,145263417
10,145403601,145521931,10_124,7481,124,145411082
10,145571280,145664791,10_125,3885,125,145575165
10,145708991,145814336,10_126,11499,126,145720490
10,145890433,145951744,10_127,17788,127,145908221
10,146056117,146114894,10_128,13901,128,146070018
10,146114936,146237639,10_129,18512,129,146133448
10,146289585,146349188,10_130,9232,130,146298817
10,146421027,146475248,10_131,13619,131,146434646
10,146498860,146602206,10_132,11576,132,146510436
10,146643348,146689699,10_133,30795,133,146674143
10,146746266,146803356,10_134,5051,134,146751317
10,146938332,146942832,10_135,1375,135,146939707
10,146943178,147049733,10_136,17776,136,146960954
10,147050060,147152350,10_137,15097,137,147065157
10,147152520,147254694,10_138,29574,138,147182094
10,147254844,147334474,10_139,7868,139,147262712
10,147354096,147451621,10_140,18584,140,147372680
10,147457245,147541375,10_141,9427,141,147466672
10,147557058,147610244,10_142,25089,142,147582147
10,147704957,147729003,10_143,7255,143,147712212
10,147816034,147821126,10_144,4563,144,147820597
10,147836227,147907436,10_145,24055,145,147860282
10,147920852,147998094,10_146,12603,146,147933455
10,148047824,148093593,10_147,6554,147,148054378
10,148095902,148171183,10_148,20097,148,148115999
10,148229119,148266499,10_149,10600,149,148239719
10,148294023,148329645,10_150,19211,150,148313234
10,148404630,148436694,10_151,17102,151,148421732
10,148501731,148525757,10_152,19371,152,148521102
10,148526965,148610082,10_153,18423,153,148545388
10,148610709,148643282,10_154,18053,154,148628762
10,148715240,148763164,10_155,4108,155,148719348
10,148780314,148856793,10_156,12860,156,148793174
10,148865191,148938015,10_157,21145,157,148886336
10,148968595,149032470,10_158,27337,158,148995932
10,149089859,149098476,10_159,8481,159,149098340
10,149195763,149201931,10_160,1638,160,149197401
10,149269368,149271870,10_161,5166,161,149274534
10,149300262,149323543,10_162,3598,162,149303860
10,149383974,149445546,10_163,5040,163,149389014
10,149530230,149531675,10_164,725,164,149530955
10,149550680,149597194,10_165,12455,165,149563135
10,149741490,149749294,10_167,10231,167,149751721
10,149808695,149818764,10_168,8318,168,149817013
10,149913815,149914228,10_169,0,169,149913815
10,150001530,150005213,10_170,0,170,150001530
10,150086721,150092983,10_171,4062,171,150090783
